冒天下之大不讳=冒天下之大不韪|冒天下之大不韙
万变不离其中=万变不离其宗|萬變不離其宗
付之于东流=付诸东流|付諸東流
付诸于东流=付诸东流|付諸東流
消声匿迹=销声匿迹|銷聲匿跡
积毁消骨=积毁销骨|積毀銷骨
消遥法外=逍遥法外|逍遙法外
不共带天=不共戴天|不共戴天
百战不贻=百战不殆|百戰不殆
缺之不恭=却之不恭|卻之不恭
望而怯步=望而却步|望而卻步
浑浑恶恶=浑浑噩噩|渾渾噩噩
材疏学浅=才疏学浅|才疏學淺
志大材疏=志大才疏|志大才疏
因才施教=因材施教|因材施教
敖敖待哺=嗷嗷待哺|嗷嗷待哺
叫苦不叠=叫苦不迭|叫苦不迭
重重迭迭=重重叠叠|重重疊疊
层层迭迭=层层叠叠|層層疊疊
跌挫强敌=迭挫强敌|迭挫強敵
迭床架屋=叠床架屋|疊床架屋
层峦迭障=层峦叠嶂|層巒疊嶂
燃汽轮机=燃气轮机|燃氣輪機
背信起义=背信弃义|背信棄義
玷玷自喜=沾沾自喜|沾沾自喜
玷亲带故=沾亲带故|沾親帶故
鞭僻入理=鞭辟入里|鞭辟入裡
鞭辟入理=鞭辟入里|鞭辟入裡
鞭僻入里=鞭辟入里|鞭辟入裡
独劈蹊径=独辟蹊径|獨闢蹊徑
辟头盖脸=劈头盖脸|劈頭蓋臉
纷至踏来=纷至沓来|紛至沓來
胀红了脸=涨红了脸|漲紅了臉
头昏脑胀=头昏脑涨|頭昏腦漲
热涨冷缩=热胀冷缩|熱脹冷縮
望风披糜=望风披靡|望風披靡
望风披縻=望风披靡|望風披靡
萎糜不振=萎靡不振|萎靡不振
萎縻不振=萎靡不振|萎靡不振
糜糜之音=靡靡之音|靡靡之音
縻糜之音=靡靡之音|靡靡之音
糜縻之音=靡靡之音|靡靡之音
縻縻之音=靡靡之音|靡靡之音
绝不罢休=决不罢休|決不罷休
坐无虚席=座无虚席|座無虛席
雪中送碳=雪中送炭|雪中送炭
生灵涂碳=生灵涂炭|生靈塗炭
异曲同功=异曲同工|異曲同工
杯工蛇影=杯弓蛇影|杯弓蛇影
左右开工=左右开弓|左右開弓
卑恭曲膝=卑躬屈膝|卑躬屈膝
卑躬曲膝=卑躬屈膝|卑躬屈膝
卑恭屈膝=卑躬屈膝|卑躬屈膝
曲打成招=屈打成招|屈打成招
洗耳躬听=洗耳恭听|洗耳恭聽
纠纠武夫=赳赳武夫|赳赳武夫
纠纠老秦=赳赳老秦|赳赳老秦
裨官野史=稗官野史|稗官野史
百练成钢=百炼成钢|百煉成鋼
爱乌及屋=爱屋及乌|愛屋及烏
按居乐业=安居乐业|安居樂業
暗然泪下=黯然泪下|黯然淚下
暗然销魂=黯然销魂|黯然銷魂
黯无天日=暗无天日|暗無天日
安兵不动=按兵不动|按兵不動
飞扬拔扈=飞扬跋扈|飛揚跋扈
白壁微瑕=白璧微瑕|白璧微瑕
大有稗益=大有裨益|大有裨益
原物必还=原物璧还|原物璧還
原物壁还=原物璧还|原物璧還
英雄倍出=英雄辈出|英雄輩出
并行不背=并行不悖|並行不悖
废尽心机=费尽心机|費盡心機
废尽心思=费尽心思|費盡心思
煞废苦心=煞费苦心|煞費苦心
半途而费=半途而废|半途而廢
费寝忘食=废寝忘食|廢寢忘食
因噎费食=因噎废食|因噎廢食
百步串杨=百步穿杨|百步穿楊
罢绌百家=罢黜百家|罷黜百家
背道而驶=背道而驰|背道而馳
弊绝风轻=弊绝风清|弊絕風清
筚路褴缕=筚路褴褛|篳路襤褸
不寒而立=不寒而栗|不寒而慄
变换莫测=变幻莫测|變幻莫測
涣然一新=焕然一新|煥然一新
精神焕散=精神涣散|精神渙散
骠肥体壮=膘肥体壮|膘肥體壯
标炳千古=彪柄千古|彪柄千古
摒气凝神=屏气凝神|屏氣凝神
病入膏盲=病入膏肓|病入膏肓
不遑顾及=不惶顾及|不惶顧及
不卑不吭=不卑不亢|不卑不亢
不卑不抗=不卑不亢|不卑不亢
不明一钱=不名一钱|不名一錢
不明一文=不名一文|不名一文
一文不明=一文不名|一文不名
至理明言=至理名言|至理名言
莫可明状=莫可名状|莫可名狀
巧立明目=巧立名目|巧立名目
宁死不曲=宁死不屈|寧死不屈
能曲能伸=能屈能伸|能屈能伸
理曲词穷=理屈词穷|理屈詞窮
屈意逢迎=曲意逢迎|曲意逢迎
委屈婉转=委曲婉转|委曲婉轉
委屈求全=委曲求全|委曲求全
灿然一笑=粲然一笑|粲然一笑
苍海桑田=沧海桑田|滄海桑田
沧茫大海=苍茫大海|蒼茫大海
藏诟纳污=藏垢纳污|藏垢納污
蓬头诟面=蓬头垢面|蓬頭垢面
测隐之心=恻隐之心|惻隱之心
缠绵悱测=缠绵悱恻|纏綿悱惻
成出不穷=层出不穷|層出不窮
一层不变=一成不变|一成不變
层见迭出=层见叠出|層見疊出
爱不失手=爱不释手|愛不釋手
不加思索=不假思索|不假思索
不径而走=不胫而走|不脛而走
不颈而走=不胫而走|不脛而走
不经而走=不胫而走|不脛而走
继往不究=既往不究|既往不究
一如继往=一如既往|一如既往
既往开来=继往开来|繼往開來
焚膏既晷=焚膏继晷|焚膏繼晷
不堪之论=不刊之论|不刊之論
不可思异=不可思议|不可思議
不求深解=不求甚解|不求甚解
插科打浑=插科打诨|插科打諢
蝉连冠军=蝉联冠军|蟬聯冠軍
浮想连翩=浮想联翩|浮想聯翩
陈陈相应=陈陈相因|陳陳相因
陈词烂调=陈词滥调|陳詞濫調
惩一禁百=惩一儆百|懲一儆百
斥之以鼻=嗤之以鼻|嗤之以鼻
忧心冲冲=忧心忡忡|憂心忡忡
出类拔粹=出类拔萃|出類拔萃
出奇不意=出其不意|出其不意
出奇致胜=出奇制胜|出奇制勝
克敌致胜=克敌制胜|克敵制勝
尉然成风=蔚然成风|蔚然成風
尉为大观=蔚为大观|蔚為大觀
出人投地=出人头地|出人頭地
投投是道=头头是道|頭頭是道
走头无路=走投无路|走投無路
五体头地=五体投地|五體投地
除旧补新=除旧布新|除舊布新
处心集虑=处心积虑|處心積慮
穿流不息=川流不息|川流不息
传颂一时=传诵一时|傳誦一時
从常计议=从长计议|從長計議
常年累月=长年累月|長年累月
扬常而去=扬长而去|揚長而去
粗枝大意=粗枝大叶|粗枝大葉
粗制烂造=粗制滥造|粗製濫造
措火积薪=厝火积薪|厝火積薪
错手不及=措手不及|措手不及
大放獗词=大放厥词|大放厥詞
大廷广众=大庭广众|大庭廣眾
大相径廷=大相径庭|大相徑庭
当人不让=当仁不让|當仁不讓
一视同人=一视同仁|一視同仁
倒打一把=倒打一耙|倒打一耙
得不尝失=得不偿失|得不償失
得垄望蜀=得陇望蜀|得隴望蜀
地大物搏=地大物博|地大物博
掂斤拨两=掂斤播两|掂斤播兩
草木雕零=草木凋零|草木凋零
凋虫小技=雕虫小技|雕蟲小技
调以轻心=掉以轻心|掉以輕心
吊虎离山=调虎离山|調虎離山
尾大不吊=尾大不掉|尾大不掉
动辙得咎=动辄得咎|動輒得咎
动则得咎=动辄得咎|動輒得咎
浅尝则止=浅尝辄止|淺嘗輒止
以毒功毒=以毒攻毒|以毒攻毒
独挡一面=独当一面|獨當一面
以一挡十=以一当十|以一當十
独占螯头=独占鳌头|獨占鰲頭
过度时期=过渡时期|過渡時期
疾贤妒能=嫉贤妒能|嫉賢妒能
愤世疾俗=愤世嫉俗|憤世嫉俗
痛心嫉首=痛心疾首|痛心疾首
手急眼快=手疾眼快|手疾眼快
急言厉色=疾言厉色|疾言厲色
大声急呼=大声疾呼|大聲疾呼
眼急手快=眼疾手快|眼疾手快
振笔急书=振笔疾书|振筆疾書
堵绝浪费=杜绝浪费|杜絕浪費
对针下药=对症下药|對症下藥
两军对恃=两军对峙|兩軍對峙
两军对持=两军对峙|兩軍對峙
绌绌逼人=咄咄逼人|咄咄逼人
拙绌逼人=咄咄逼人|咄咄逼人
绌拙逼人=咄咄逼人|咄咄逼人
拙拙逼人=咄咄逼人|咄咄逼人
如雷灌耳=如雷贯耳|如雷貫耳
恶灌满盈=恶贯满盈|惡貫滿盈
发号司令=发号施令|發號施令
各施其职=各司其职|各司其職
震聋发聩=振聋发聩|振聾發聵
震震有词=振振有词|振振有詞
举世振惊=举世震惊|舉世震驚
令人发直=令人发指|令人髮指
要言不繁=要言不烦|要言不煩
防患未燃=防患未然|防患未然
成绩蜚然=成绩斐然|成績斐然
非夷所思=匪夷所思|匪夷所思
分道扬标=分道扬镳|分道揚鑣
愤闷不平=愤懑不平|憤懣不平
愤笔急书=奋笔疾书|奮筆疾書
愤笔疾书=奋笔疾书|奮筆疾書
奋笔急书=奋笔疾书|奮筆疾書
蜂涌而至=蜂拥而至|蜂擁而至
一涌而入=一拥而入|一擁而入
凤冠霞披=凤冠霞帔|鳳冠霞帔
浮光略影=浮光掠影|浮光掠影
付之东流=付诸东流|付諸東流
言简意该=言简意赅|言簡意賅
甘之如怡=甘之如饴|甘之如飴
心旷神饴=心旷神怡|心曠神怡
工力悉抵=工力悉敌|工力悉敵
寡不抵众=寡不敌众|寡不敵眾
功亏一蒉=功亏一篑|功虧一簣
全神灌注=全神贯注|全神貫注
鬼斧神功=鬼斧神工|鬼斧神工
鬼域技俩=鬼蜮伎俩|鬼蜮伎倆
过尤不及=过犹不及|過猶不及
困兽尤斗=困兽犹斗|困獸猶鬥
记忆尤新=记忆犹新|記憶猶新
怨天犹人=怨天尤人|怨天尤人
无耻之犹=无耻之尤|無恥之尤
禁若寒蝉=噤若寒蝉|噤若寒蟬
合盘托出=和盘托出|和盤托出
合衷共济=和衷共济|和衷共濟
曲高合寡=曲高和寡|曲高和寡
划地为牢=画地为牢|畫地為牢
独具惠眼=独具慧眼|獨具慧眼
拾人牙惠=拾人牙慧|拾人牙慧
昏馈无能=昏聩无能|昏聵無能
浑玉朴金=浑玉璞金|渾玉璞金
忽然开朗=豁然开朗|豁然開朗
祸国秧民=祸国殃民|禍國殃民
击浊扬清=激浊扬清|激濁揚清
集液成裘=集腋成裘|集腋成裘
无计于事=无济于事|無濟於事
挤挤一堂=济济一堂|濟濟一堂
计日成功=计日程功|計日程功
佳言懿行=嘉言懿行|嘉言懿行
精神可佳=精神可嘉|精神可嘉
矫糅造作=矫揉造作|矯揉造作
矫柔造作=矫揉造作|矯揉造作
接长补短=截长补短|截長補短
直接了当=直截了当|直截了當
斩钉接铁=斩钉截铁|斬釘截鐵
移花截木=移花接木|移花接木
可资借戒=可资借鉴|可資借鑒
前车之戒=前车之鉴|前車之鑒
弱不经风=弱不禁风|弱不禁風
金壁辉煌=金碧辉煌|金碧輝煌
金钢钻头=金刚钻头|金剛鑽頭
精兵减政=精兵简政|精兵簡政
偷工简料=偷工减料|偷工減料
居心不测=居心叵测|居心叵測
以警效尤=以儆效尤|以儆效尤
鸩形鹄面=鸠形鹄面|鳩形鵠面
饮鸠止渴=饮鸩止渴|飲鴆止渴
拒谏是非=拒谏饰非|拒諫飾非
精神矍烁=精神矍铄|精神矍鑠
烁石流金=铄石流金|鑠石流金
众口烁金=众口铄金|眾口鑠金
开天劈地=开天辟地|開天闢地
开中明义=开宗明义|開宗明義
科头洗足=科头跣足|科頭跣足
刻己奉公=克己奉公|克己奉公
刻勤刻俭=克勤克俭|克勤克儉
克苦耐劳=刻苦耐劳|刻苦耐勞
夸夸奇谈=夸夸其谈|誇誇其談
宽弘大量=宽宏大量|寬宏大量
宽洪大量=宽宏大量|寬宏大量
宏扬文化=弘扬文化|弘揚文化
味同嚼腊=味同嚼蜡|味同嚼蠟
意兴阑姗=意兴阑珊|意興闌珊
无耻滥言=无耻谰言|無恥讕言
宁缺毋烂=宁缺毋滥|寧缺毋濫
老陈持重=老成持重|老成持重
老诚持重=老成持重|老成持重
其乐淘淘=其乐陶陶|其樂陶陶
手屈一指=首屈一指|首屈一指
首曲一指=首屈一指|首屈一指
立功渎罪=立功赎罪|立功贖罪
利精图治=励精图治|勵精圖治
历精图治=励精图治|勵精圖治
厉精图治=励精图治|勵精圖治
力精图治=励精图治|勵精圖治
再接再利=再接再厉|再接再厲
再接再历=再接再厉|再接再厲
再接再励=再接再厉|再接再厲
再接再力=再接再厉|再接再厲
声色俱利=声色俱厉|聲色俱厲
声色俱历=声色俱厉|聲色俱厲
声色俱励=声色俱厉|聲色俱厲
声色俱力=声色俱厉|聲色俱厲
色利内荏=色厉内荏|色厲內荏
色历内荏=色厉内荏|色厲內荏
色励内荏=色厉内荏|色厲內荏
色力内荏=色厉内荏|色厲內荏
雷历风行=雷厉风行|雷厲風行
雷励风行=雷厉风行|雷厲風行
雷力风行=雷厉风行|雷厲風行
雷利风行=雷厉风行|雷厲風行
利兵秣马=厉兵秣马|厲兵秣馬
历兵秣马=厉兵秣马|厲兵秣馬
励兵秣马=厉兵秣马|厲兵秣馬
力兵秣马=厉兵秣马|厲兵秣馬
变本加力=变本加厉|變本加厲
变本加利=变本加厉|變本加厲
变本加历=变本加厉|變本加厲
变本加励=变本加厉|變本加厲
利行节约=厉行节约|厲行節約
历行节约=厉行节约|厲行節約
励行节约=厉行节约|厲行節約
力行节约=厉行节约|厲行節約
厉厉在目=历历在目|歷歷在目
利厉在目=历历在目|歷歷在目
励厉在目=历历在目|歷歷在目
力厉在目=历历在目|歷歷在目
厉利在目=历历在目|歷歷在目
利利在目=历历在目|歷歷在目
励利在目=历历在目|歷歷在目
力利在目=历历在目|歷歷在目
厉励在目=历历在目|歷歷在目
利励在目=历历在目|歷歷在目
励励在目=历历在目|歷歷在目
力励在目=历历在目|歷歷在目
厉力在目=历历在目|歷歷在目
利力在目=历历在目|歷歷在目
励力在目=历历在目|歷歷在目
力力在目=历历在目|歷歷在目
铺张扬利=铺张扬厉|鋪張揚厲
色厉内忍=色厉内荏|色厲內荏
藕断丝联=藕断丝连|藕斷絲連
横征暴殓=横征暴敛|橫征暴斂
廖若晨星=寥若晨星|寥若晨星
一麟半爪=一鳞半爪|一鱗半爪
留恋忘返=留连忘返|留連忘返
老态龙肿=老态龙钟|老態龍鍾
炉火成青=炉火纯青|爐火純青
暂露头角=崭露头角|嶄露頭角
戳力同心=戮力同心|戮力同心
旅力过人=膂力过人|膂力過人
攻城掠地=攻城略地|攻城略地
沦肌夹髓=沦肌浃髓|淪肌浹髓
汗流夹背=汗流浃背|汗流浹背
无与纶比=无与伦比|無與倫比
无与论比=无与伦比|無與倫比
满腹经伦=满腹经纶|滿腹經綸
满腹经论=满腹经纶|滿腹經綸
羽扇伦巾=羽扇纶巾|羽扇綸巾
羽扇论巾=羽扇纶巾|羽扇綸巾
轮功行赏=论功行赏|論功行賞
漫条斯理=慢条斯理|慢條斯理
慢不经心=漫不经心|漫不經心
茫无头序=茫无头绪|茫無頭緒
千头万序=千头万绪|千頭萬緒
一切就序=一切就绪|一切就緒
冒然从事=贸然从事|貿然從事
素昧平身=素昧平生|素昧平生
门里出生=门里出身|門裡出身
谈笑风声=谈笑风生|談笑風生
老声常谈=老生常谈|老生常談
门廷若市=门庭若市|門庭若市
朦懂无知=懵懂无知|懵懂無知
靡烂不堪=糜烂不堪|糜爛不堪
风糜一时=风靡一时|風靡一時
迷天大谎=弥天大谎|彌天大謊
欲盖迷彰=欲盖弥彰|欲蓋彌彰
欲盖迷张=欲盖弥彰|欲蓋彌彰
欲盖弥张=欲盖弥彰|欲蓋彌彰
密而不宣=秘而不宣|秘而不宣
祖传密方=祖传秘方|祖傳秘方
死不冥目=死不瞑目|死不瞑目
死不溟目=死不瞑目|死不瞑目
薄暮暝暝=薄暮冥冥|薄暮冥冥
暝暝之中=冥冥之中|冥冥之中
明查暗访=明察暗访|明察暗訪
名哲保身=明哲保身|明哲保身
名珠暗投=明珠暗投|明珠暗投
磨肩擦背=摩肩擦背|摩肩擦背
磨崖石刻=摩崖石刻|摩崖石刻
顶礼模拜=顶礼膜拜|頂禮膜拜
穷途没路=穷途末路|窮途末路
末齿不忘=没齿不忘|沒齒不忘
莫中一是=莫衷一是|莫衷一是
言不由中=言不由衷|言不由衷
中心感谢=衷心感谢|衷心感謝
一见衷情=一见钟情|一見鍾情
谋取暴利=牟取暴利|牟取暴利
暮蔼沉沉=暮霭沉沉|暮靄沉沉
暇迩闻名=遐迩闻名|遐邇聞名
瑕迩闻名=遐迩闻名|遐邇聞名
闻名暇迩=闻名遐迩|聞名遐邇
闻名瑕迩=闻名遐迩|聞名遐邇
名闻暇迩=名闻遐迩|名聞遐邇
名闻瑕迩=名闻遐迩|名聞遐邇
目不瑕接=目不暇接|目不暇接
目不遐接=目不暇接|目不暇接
应接不遐=应接不暇|應接不暇
应接不瑕=应接不暇|應接不暇
暇思迩想=遐思迩想|遐思邇想
瑕思迩想=遐思迩想|遐思邇想
暇瑜互见=瑕瑜互见|瑕瑜互見
遐瑜互见=瑕瑜互见|瑕瑜互見
自顾不遐=自顾不暇|自顧不暇
自顾不瑕=自顾不暇|自顧不暇
令人目炫=令人目眩|令人目眩
头昏目炫=头昏目眩|頭昏目眩
盘根错结=盘根错节|盤根錯節
不拘小结=不拘小节|不拘小節
细枝末结=细枝末节|細枝末節
判若洪沟=判若鸿沟|判若鴻溝
披肝厉胆=披肝沥胆|披肝瀝膽
凭心而论=平心而论|平心而論
风尘扑扑=风尘仆仆|風塵僕僕
风尘朴扑=风尘仆仆|風塵僕僕
风尘扑朴=风尘仆仆|風塵僕僕
风尘朴朴=风尘仆仆|風塵僕僕
前扑后继=前仆后继|前仆後繼
前朴后继=前仆后继|前仆後繼
仆朔迷离=扑朔迷离|撲朔迷離
朴朔迷离=扑朔迷离|撲朔迷離
气喘嘘嘘=气喘吁吁|氣喘吁吁
自我吹吁=自我吹嘘|自我吹噓
吁寒问暖=嘘寒问暖|噓寒問暖
气极败坏=气急败坏|氣急敗壞
气势凶凶=气势汹汹|氣勢洶洶
讫今为止=迄今为止|迄今為止
斩将骞旗=斩将搴旗|斬將搴旗
千古一痛=千古一恸|千古一慟
深致欠意=深致歉意|深致歉意
敲榨勒索=敲诈勒索|敲詐勒索
巧装打扮=乔装打扮|喬裝打扮
巧夺天公=巧夺天工|巧奪天工
契而不舍=锲而不舍|鍥而不捨
浸人心脾=沁人心脾|沁人心脾
穷穷孑立=茕茕孑立|煢煢孑立
雀巢鸠占=鹊巢鸠占|鵲巢鳩占
鸠占雀巢=鸠占鹊巢|鳩占鵲巢
欢呼鹊跃=欢呼雀跃|歡呼雀躍
惹事生非=惹是生非|惹是生非
招惹事非=招惹是非|招惹是非
各行其事=各行其是|各行其是
共商国事=共商国是|共商國是
无是生非=无事生非|無事生非
寻人启是=寻人启事|尋人啟事
忍劳忍怨=任劳任怨|任勞任怨
儒子可教=孺子可教|孺子可教
如丧考比=如丧考妣|如喪考妣
大现身手=大显身手|大顯身手
歌舞生平=歌舞升平|歌舞升平
拾遗补缺=拾遗补阙|拾遺補闕
势如爆竹=势如破竹|勢如破竹
收来人心=收揽人心|收攬人心
毁家抒难=毁家纾难|毀家紓難
毁家书难=毁家纾难|毀家紓難
越俎代包=越俎代庖|越俎代庖
越组代包=越俎代庖|越俎代庖
越祖代包=越俎代庖|越俎代庖
越组代庖=越俎代庖|越俎代庖
越祖代庖=越俎代庖|越俎代庖
追本朔源=追本溯源|追本溯源
昙花一显=昙花一现|曇花一現
丢人显眼=丢人现眼|丟人現眼
显身说法=现身说法|現身說法
坦胸露臂=袒胸露臂|袒胸露臂
坦胸露乳=袒胸露乳|袒胸露乳
坦露上身=袒露上身|袒露上身
袒诚相见=坦诚相见|坦誠相見
长嘘短叹=长吁短叹|長吁短嘆
富丽唐皇=富丽堂皇|富麗堂皇
桃梨满园=桃李满园|桃李滿園
醍醐贯顶=醍醐灌顶|醍醐灌頂
提心掉胆=提心吊胆|提心吊膽
形影相掉=形影相吊|形影相吊
题纲挈领=提纲挈领|提綱挈領
题纲携领=提纲挈领|提綱挈領
提纲携领=提纲挈领|提綱挈領
天经地仪=天经地义|天經地義
婷婷玉立=亭亭玉立|亭亭玉立
挺而走险=铤而走险|鋌而走險
通货膨涨=通货膨胀|通貨膨脹
图谋不规=图谋不轨|圖謀不軌
步入正规=步入正轨|步入正軌
图穷匕现=图穷匕见|圖窮匕見
推陈相见=推诚相见|推誠相見
推托责任=推脱责任|推脫責任
推心至腹=推心置腹|推心置腹
推心质腹=推心置腹|推心置腹
毋庸质疑=毋庸置疑|毋庸置疑
不容质疑=不容置疑|不容置疑
不可质疑=不可置疑|不可置疑
退化变质=蜕化变质|蛻化變質
屯积居奇=囤积居奇|囤積居奇
脱颍而出=脱颖而出|脫穎而出
歪风斜气=歪风邪气|歪風邪氣
歪门斜道=歪门邪道|歪門邪道
改斜归正=改邪归正|改邪歸正
玩世不公=玩世不恭|玩世不恭
万古常青=万古长青|萬古長青
万冠家财=万贯家财|萬貫家財
置若惘闻=置若罔闻|置若罔聞
忘夫所以=忘乎所以|忘乎所以
名门旺族=名门望族|名門望族
喜出往外=喜出望外|喜出望外
望洋心叹=望洋兴叹|望洋興嘆
正襟威坐=正襟危坐|正襟危坐
危如磊卵=危如累卵|危如累卵
运筹惟幄=运筹帷幄|運籌帷幄
运筹唯幄=运筹帷幄|運籌帷幄
运筹维幄=运筹帷幄|運籌帷幄
运筹惟握=运筹帷幄|運籌帷幄
运筹唯握=运筹帷幄|運籌帷幄
运筹维握=运筹帷幄|運籌帷幄
运筹帷握=运筹帷幄|運籌帷幄
不温不火=不瘟不火|不瘟不火
闻过饰非=文过饰非|文過飾非
有条不稳=有条不紊|有條不紊
协从不问=胁从不问|脅從不問
无人问斤=无人问津|無人問津
坐想其成=坐享其成|坐享其成
暴烈恣睢=暴戾恣睢|暴戾恣睢
自立更生=自力更生|自力更生
自名得意=自鸣得意|自鳴得意
自名不凡=自命不凡|自命不凡
纵横捭合=纵横捭阖|縱橫捭闔
卓智多谋=足智多谋|足智多謀
飞机着落=飞机着陆|飛機著陸
抓耳扰腮=抓耳挠腮|抓耳撓腮
钟灵玉秀=钟灵毓秀|鍾靈毓秀
奋斗终身=奋斗终生|奮鬥終生
舍身取义=舍生取义|捨生取義
素未平身=素未平生|素未平生
终生大事=终身大事|終身大事
不浮众望=不孚众望|不孚眾望
口株笔伐=口诛笔伐|口誅筆伐
诛连无辜=株连无辜|株連無辜
振济灾民=赈济灾民|賑濟災民
指手划脚=指手画脚|指手畫腳
珍重其事=郑重其事|鄭重其事
风雨如诲=风雨如晦|風雨如晦
直言不晦=直言不讳|直言不諱
表本兼治=标本兼治|標本兼治
治丝益纷=治丝益棼|治絲益棼
轶序井然=秩序井然|秩序井然
远见灼识=远见卓识|遠見卓識
真知卓见=真知灼见|真知灼見
作奸犯课=作奸犯科|作姦犯科
照本宣课=照本宣科|照本宣科
照然若揭=昭然若揭|昭然若揭
仗义输财=仗义疏财|仗義疏財
明火执杖=明火执仗|明火執仗
张惶失措=张皇失措|張皇失措
彰善惮恶=彰善瘅恶|彰善癉惡
战战精精=战战兢兢|戰戰兢兢
战战竞精=战战兢兢|戰戰兢兢
战战惊精=战战兢兢|戰戰兢兢
战战精竞=战战兢兢|戰戰兢兢
战战竞竞=战战兢兢|戰戰兢兢
战战惊竞=战战兢兢|戰戰兢兢
战战精惊=战战兢兢|戰戰兢兢
战战竞惊=战战兢兢|戰戰兢兢
战战惊惊=战战兢兢|戰戰兢兢
精精业业=兢兢业业|兢兢業業
竞精业业=兢兢业业|兢兢業業
惊精业业=兢兢业业|兢兢業業
精竞业业=兢兢业业|兢兢業業
竞竞业业=兢兢业业|兢兢業業
惊竞业业=兢兢业业|兢兢業業
精惊业业=兢兢业业|兢兢業業
竞惊业业=兢兢业业|兢兢業業
惊惊业业=兢兢业业|兢兢業業
令人乍舌=令人咋舌|令人咋舌
古今杂揉=古今杂糅|古今雜糅
陨身不恤=殒身不恤|殞身不恤
纭纭众生=芸芸众生|蕓蕓眾生
沿木求鱼=缘木求鱼|緣木求魚
语无论次=语无伦次|語無倫次
语无仑次=语无伦次|語無倫次
余勇可沽=余勇可贾|餘勇可賈
宥于成见=囿于成见|囿於成見
估名钓誉=沽名钓誉|沽名釣譽
有口皆杯=有口皆碑|有口皆碑
耳根清静=耳根清净|耳根清凈
利害悠关=利害攸关|利害攸關
犹柔寡断=优柔寡断|優柔寡斷
忧柔寡断=优柔寡断|優柔寡斷
涌跃报名=踊跃报名|踴躍報名
永往直前=勇往直前|勇往直前
永保青春=永葆青春|永葆青春
拥塞不通=壅塞不通|壅塞不通
壅荣华贵=雍荣华贵|雍榮華貴
影影约约=隐隐约约|隱隱約約
隐隐绰绰=影影绰绰|影影綽綽
引疚自责=引咎自责|引咎自責
肄无忌惮=肆无忌惮|肆無忌憚
不郎不莠=不郎不秀|不郎不秀
良秀不齐=良莠不齐|良莠不齊
依仗权势=倚仗权势|倚仗權勢
以老卖老=倚老卖老|倚老賣老
以逸代劳=以逸待劳|以逸待勞
严阵以代=严阵以待|嚴陣以待
贻然自得=怡然自得|怡然自得
毫无疑议=毫无疑义|毫無疑義
不可思义=不可思议|不可思議
一喏千金=一诺千金|一諾千金
一劳永易=一劳永逸|一勞永逸
一獗不振=一蹶不振|一蹶不振
一鼓足气=一鼓作气|一鼓作氣
不作为训=不足为训|不足為訓
一盖而论=一概而论|一概而論
以偏盖全=以偏概全|以偏概全
钓销执照=吊销执照|吊銷執照
钓消执照=吊销执照|吊銷執照
吊消执照=吊销执照|吊銷執照
弃甲拽兵=弃甲曳兵|棄甲曳兵
跃武扬威=耀武扬威|耀武揚威
指高气扬=趾高气扬|趾高氣揚
扬扬洒洒=洋洋洒洒|洋洋灑灑
眼花撩乱=眼花缭乱|眼花繚亂
严正申明=严正声明|嚴正聲明
和言悦色=和颜悦色|和顏悅色
察颜观色=察言观色|察言觀色
淹没无闻=湮没无闻|湮沒無聞
厌厌欲睡=恹恹欲睡|懨懨欲睡
央央大国=泱泱大国|泱泱大國
器度不凡=气度不凡|氣度不凡
喧然大波=轩然大波|軒然大波
沆泄一气=沆瀣一气|沆瀣一氣
别出新裁=别出心裁|別出心裁
心劳日绌=心劳日拙|心勞日拙
睡眼醒松=睡眼惺忪|睡眼惺忪
猩猩作态=惺惺作态|惺惺作態
凶相必露=凶相毕露|凶相畢露
原形必露=原形毕露|原形畢露
锋芒必露=锋芒毕露|鋒芒畢露
修养生息=休养生息|休養生息
学识休养=学识修养|學識修養
扶老偕幼=扶老携幼|扶老攜幼
白头携老=白头偕老|白頭偕老
风雨萧萧=风雨潇潇|風雨瀟瀟
宵衣干食=宵衣旰食|宵衣旰食
降龙服虎=降龙伏虎|降龍伏虎
认罪服法=认罪伏法|認罪伏法
安置若素=安之若素|安之若素
下车一始=下车伊始|下車伊始
相辅相承=相辅相成|相輔相成
畏崽不前=畏葸不前|畏葸不前
歇事宁人=息事宁人|息事寧人
作歇时间=作息时间|作息時間
无泄可击=无懈可击|無懈可擊
无细可乘=无隙可乘|無隙可乘
无所是从=无所适从|無所適從
无尚光荣=无上光荣|無上光榮
至高无尚=至高无上|至高無上
无计之谈=无稽之谈|無稽之談
无讥之谈=无稽之谈|無稽之談
反唇相击=反唇相讥|反唇相譏
反来复去=翻来覆去|翻來覆去
反来覆去=翻来覆去|翻來覆去
翻来复去=翻来覆去|翻來覆去
造谣装骗=招摇撞骗|招搖撞騙
造谣撞骗=招摇撞骗|招搖撞騙
招摇装骗=招摇撞骗|招搖撞騙
板上走丸=阪上走丸|阪上走丸
坂上走丸=阪上走丸|阪上走丸
趁心如意=称心如意|稱心如意
墨守陈规=墨守成规|墨守成規
默守成规=墨守成规|墨守成規
默守陈规=墨守陈规|墨守陳規
入不付出=入不敷出|入不敷出
英雄气慨=英雄气概|英雄氣概
行踪鬼秘=行踪诡秘|行蹤詭秘
阴谋鬼计=阴谋诡计|陰謀詭計
情不自尽=情不自禁|情不自禁
龙盘虎据=龙盘虎踞|龍盤虎踞
棵粒归仓=颗粒归仓|顆粒歸倉
评头评足=品头评足|品頭評足
评头论足=品头论足|品頭論足
大多类同=大多雷同|大多雷同
沤心沥血=呕心沥血|嘔心瀝血
星罗旗布=星罗棋布|星羅棋布
沽恶不悛=怙恶不悛|怙惡不悛
怙恶不俊=怙恶不悛|怙惡不悛
大伤原气=大伤元气|大傷元氣
原气大伤=元气大伤|元氣大傷
改弦更章=改弦更张|改弦更張
改弦易章=改弦易张|改弦易張
渊远流长=源远流长|源遠流長
众目暌暌=众目睽睽|眾目睽睽
人心项背=人心向背|人心向背
毋用讳言=毋庸讳言|毋庸諱言
支无其词=支吾其词|支吾其詞
切搓琢磨=切磋琢磨|切磋琢磨
无忘之灾=无妄之灾|無妄之災
不既不离=不即不离|不即不離
不醒人事=不省人事|不省人事
不言而语=不言而喻|不言而喻
不另赐教=不吝赐教|不吝賜教
世无前例=史无前例|史無前例
尽心极力=尽心竭力|盡心竭力
言之足足=言之凿凿|言之鑿鑿
投鼠计器=投鼠忌器|投鼠忌器
淄铢必较=锱铢必较|錙銖必較
声名雀起=声名鹊起|聲名鵲起
为丛驱鹊=为丛驱雀|為叢驅雀
悬梁刺骨=悬梁刺股|懸梁刺股
震憾人心=震撼人心|震撼人心
娇揉造作=矫揉造作|矯揉造作
一诺千斤=一诺千金|一諾千金
不落巢臼=不落窠臼|不落窠臼
烩炙人口=脍炙人口|膾炙人口
美仑美奂=美轮美奂|美輪美奐
蛛丝蚂迹=蛛丝马迹|蛛絲馬跡
坠落腐化=堕落腐化|墮落腐化
摇摇欲堕=摇摇欲坠|搖搖欲墜
呱呱堕地=呱呱坠地|呱呱墜地
义不容词=义不容辞|義不容辭
声音宏亮=声音洪亮|聲音洪亮
富丽堂黄=富丽堂皇|富麗堂皇
金殴无缺=金瓯无缺|金甌無缺
箴口不言=缄口不言|緘口不言
批沙拣金=披沙拣金|披沙揀金
事过景迁=事过境迁|事過境遷
奇角之势=掎角之势|掎角之勢
循序前进=循序渐进|循序漸進
寻序渐进=循序渐进|循序漸進
如梗在喉=如鲠在喉|如鯁在喉
留芳百世=流芳百世|流芳百世
暴舔天物=暴殄天物|暴殄天物
按途索骥=按图索骥|按圖索驥
循章摘句=寻章摘句|尋章摘句
桀傲不驯=桀骜不驯|桀驁不馴
万马齐暗=万马齐喑|萬馬齊喑
以身作责=以身作则|以身作則
揣揣不安=惴惴不安|惴惴不安
虚座以待=虚左以待|虛左以待
远大报负=远大抱负|遠大抱負
蓄意抱复=蓄意报复|蓄意報復
投桃抱李=投桃报李|投桃報李
以德抱怨=以德报怨|以德報怨
以直抱怨=以德报怨|以德報怨
报怨不堪=抱怨不堪|抱怨不堪
璀烂夺目=璀璨夺目|璀璨奪目
连篇累椟=连篇累牍|連篇累牘
买牍还珠=买椟还珠|買櫝還珠
嘎然而止=戛然而止|戛然而止
一一例举=一一列举|一一列舉
琅琅乾坤=朗朗乾坤|朗朗乾坤
扭怩作态=忸怩作态|忸怩作態
罪蘖深重=罪孽深重|罪孽深重
一杯黄土=一抔黄土|一抔黃土
返朴归真=返璞归真|返璞歸真
坚如盘石=坚如磐石|堅如磐石
陪礼道歉=赔礼道歉|賠禮道歉
哑雀无声=鸦雀无声|鴉雀無聲
欢心鼓舞=欢欣鼓舞|歡欣鼓舞
故弄悬虚=故弄玄虚|故弄玄虛
住足不前=驻足不前|駐足不前
青春永住=青春永驻|青春永駐
股票增殖=股票增值|股票增值
和舟共济=和衷共济|和衷共濟
卷秩浩繁=卷帙浩繁|卷帙浩繁
厉害得失=利害得失|利害得失
灵牙俐齿=伶牙俐齿|伶牙俐齒
行将末落=行将没落|行將沒落
坐阵指挥=坐镇指挥|坐鎮指揮
严加防犯=严加防范|嚴加防範
惊滔骇浪=惊涛骇浪|驚濤駭浪
统盘考虑=通盘考虑|通盤考慮
针贬时弊=针砭时弊|針砭時弊
罗哩啰唆=啰哩啰唆|囉哩囉唆
罗里啰唆=啰哩啰唆|囉哩囉唆
罗哩罗唆=啰哩啰唆|囉哩囉唆
罗里罗唆=啰哩啰唆|囉哩囉唆
啰里啰唆=啰哩啰唆|囉哩囉唆
啰里罗唆=啰哩啰唆|囉哩囉唆
啰哩罗唆=啰哩啰唆|囉哩囉唆
掀风作浪=兴风作浪|興風作浪
拼拼揍揍=拼拼凑凑|拼拼湊湊
天崩地折=天崩地坼|天崩地坼
天崩地拆=天崩地坼|天崩地坼
到还挺好=倒还挺好|倒還挺好
为国捐驱=为国捐躯|為國捐軀
莫不关心=漠不关心|漠不關心
耳儒目染=耳濡目染|耳濡目染
嗜酒成僻=嗜酒成癖|嗜酒成癖
不辨黍麦=不辨菽麦|不辨菽麥
辰己午未=辰巳午未|辰巳午未
相矩不远=相距不远|相距不遠
规规距距=规规矩矩|規規矩矩
倾刻之间=顷刻之间|頃刻之間
不宵一顾=不屑一顾|不屑一顧
一望无银=一望无垠|一望無垠
申酉戍亥=申酉戌亥|申酉戌亥
抛地有声=掷地有声|擲地有聲
怨天由人=怨天尤人|怨天尤人
从中干旋=从中斡旋|從中斡旋
雨声浙沥=雨声淅沥|雨聲淅瀝
月明星希=月明星稀|月明星稀
条分缕拆=条分缕析|條分縷析
断壁颓桓=断壁颓垣|斷壁頹垣
断壁残桓=断壁残垣|斷壁殘垣
断瓦残桓=断瓦残垣|斷瓦殘垣
姿意妄为=恣意妄为|恣意妄為
故作恣态=故作姿态|故作姿態
一口同声=异口同声|異口同聲
饶勇善战=骁勇善战|驍勇善戰
高官厚录=高官厚禄|高官厚祿
人工只能=人工智能|人工智能
开诚不公=开诚布公|開誠布公
洽如其分=恰如其分|恰如其分
博识恰闻=博识洽闻|博識洽聞
泥砂俱下=泥沙俱下|泥沙俱下
泥纱俱下=泥沙俱下|泥沙俱下
个中三味=个中三昧|個中三昧
不详之兆=不祥之兆|不祥之兆
面容慈详=面容慈祥|面容慈祥
宣宾夺主=喧宾夺主|喧賓奪主
暄宾夺主=喧宾夺主|喧賓奪主
九洲方圆=九州方圆|九州方圓
九洲同庆=九州同庆|九州同慶
心浮气燥=心浮气躁|心浮氣躁
心浮气噪=心浮气躁|心浮氣躁
鼓燥而进=鼓噪而进|鼓噪而進
鼓躁而进=鼓噪而进|鼓噪而進
不骄不燥=不骄不躁|不驕不躁
贪脏枉法=贪赃枉法|貪贓枉法
千锤百练=千锤百炼|千錘百煉
千锤百拣=千锤百炼|千錘百煉
黄梁美梦=黄粱美梦|黃粱美夢
一枕黄梁=一枕黄粱|一枕黃粱
棉里藏针=绵里藏针|綿裡藏針
执谜不悟=执迷不悟|執迷不悟
篷筚生辉=蓬荜生辉|蓬蓽生輝
不记其数=不计其数|不計其數
穷原竞委=穷原竟委|窮原竟委
面面具到=面面俱到|面面俱到
万籁具寂=万籁俱寂|萬籟俱寂
五色斑澜=五色斑斓|五色斑斕
五色斑烂=五色斑斓|五色斑斕
五彩斑澜=五彩斑斓|五彩斑斕
五彩斑烂=五彩斑斓|五彩斑斕
麻木不忍=麻木不仁|麻木不仁
为富不忍=为富不仁|為富不仁
易如翻掌=易如反掌|易如反掌
翻复无常=反复无常|反覆無常
三翻两次=三番两次|三番兩次
拨乱返正=拨乱反正|撥亂反正
义无返顾=义无反顾|義無反顧
举一返三=举一反三|舉一反三
物极必返=物极必反|物極必反
回光反照=回光返照|回光返照
反云覆雨=翻云覆雨|翻雲覆雨
返云覆雨=翻云覆雨|翻雲覆雨
一幅对联=一副对联|一副對聯
百尺杆头=百尺竿头|百尺竿頭
振耳欲聋=震耳欲聋|震耳欲聾
作贼心虚=做贼心虚|做賊心虛
磕磕拌拌=磕磕绊绊|磕磕絆絆
自曝自弃=自暴自弃|自暴自棄
自爆自弃=自暴自弃|自暴自棄
丰富多采=丰富多彩|豐富多彩
别出心才=别出心裁|別出心裁
一张一驰=一张一弛|一張一弛
张驰有度=张弛有度|張弛有度
有张有驰=有张有弛|有張有弛
人所不耻=人所不齿|人所不齒
纲纪废驰=纲纪废弛|綱紀廢弛
能言善辨=能言善辩|能言善辯
中流抵柱=中流砥柱|中流砥柱
死心踏地=死心塌地|死心塌地
死心蹋地=死心塌地|死心塌地
一踏糊涂=一塌糊涂|一塌糊塗
一蹋糊涂=一塌糊涂|一塌糊塗
除恶勿尽=除恶务尽|除惡務盡
万相更新=万象更新|萬象更新
万像更新=万象更新|萬象更新
真象大白=真相大白|真相大白
真像大白=真相大白|真相大白
一泄千里=一泻千里|一瀉千里
义气用事=意气用事|意氣用事
义气风发=意气风发|意氣風發
义气相投=意气相投|意氣相投
词不达义=词不达意|詞不達意
断章取意=断章取义|斷章取義
深明大意=深明大义|深明大義
忘恩负意=忘恩负义|忘恩負義
微言大意=微言大义|微言大義
意正词严=义正词严|義正詞嚴
化学反映=化学反应|化學反應
反应意见=反映意见|反映意見
连锁反映=连锁反应|連鎖反應
先发治人=先发制人|先發制人
后发治人=后发制人|後發制人
因地治宜=因地制宜|因地制宜
决无仅有=绝无仅有|絕無僅有
赞不决口=赞不绝口|贊不絕口
决对服从=绝对服从|絕對服從
开源截流=开源节流|開源節流
连合声明=联合声明|聯合聲明
珠连璧合=珠联璧合|珠聯璧合
其乐溶溶=其乐融融|其樂融融
春光溶溶=春光融融|春光融融
步履维坚=步履维艰|步履維艱
艰壁清野=坚壁清野|堅壁清野
艰不可摧=坚不可摧|堅不可摧
无艰不摧=无坚不摧|無堅不摧
艰忍不拔=坚忍不拔|堅忍不拔
披艰执锐=披坚执锐|披堅執銳
不接不离=不即不离|不即不離
混水摸鱼=浑水摸鱼|渾水摸魚
浑为一谈=混为一谈|混為一談
沓无音信=杳无音信|杳無音信
瞻养父母=赡养父母|贍養父母
为人帅表=为人师表|為人師表
戍戌政变=戊戌政变|戊戌政變
民生凋蔽=民生凋敝|民生凋敝
蔽帚自珍=敝帚自珍|敝帚自珍
如火如茶=如火如荼|如火如荼
人情事故=人情世故|人情世故
无精打彩=无精打采|無精打采
没精打彩=没精打采|沒精打采
兴高彩烈=兴高采烈|興高采烈
心原意马=心猿意马|心猿意馬
心广神怡=心旷神怡|心曠神怡
心心相映=心心相印|心心相印
行迹可疑=形迹可疑|形跡可疑
笑语郎郎=笑语朗朗|笑語朗朗
悬涯勒马=悬崖勒马|懸崖勒馬
天崖海角=天涯海角|天涯海角
偃苗助长=揠苗助长|揠苗助長
揠旗息鼓=偃旗息鼓|偃旗息鼓
掩旗息鼓=偃旗息鼓|偃旗息鼓
一笔钩销=一笔勾销|一筆勾銷
一笔钩消=一笔勾销|一筆勾銷
一笔勾消=一笔勾销|一筆勾銷
一脉相成=一脉相承|一脈相承
一促而就=一蹴而就|一蹴而就
一股作气=一鼓作气|一鼓作氣
一愁莫展=一筹莫展|一籌莫展
义愤填赝=义愤填膺|義憤填膺
遗笑大方=贻笑大方|貽笑大方
遗害无穷=贻害无穷|貽害無窮
不贻余力=不遗余力|不遺餘力
责无旁代=责无旁贷|責無旁貸
责无旁待=责无旁贷|責無旁貸
严惩不待=严惩不贷|嚴懲不貸
严惩不代=严惩不贷|嚴懲不貸
遮天避日=遮天蔽日|遮天蔽日
仗义直言=仗义执言|仗義執言
张慌失措=张皇失措|張皇失措
张灯结采=张灯结彩|張燈結彩
灸手可热=炙手可热|炙手可熱
直抒胸意=直抒胸臆|直抒胸臆
直书胸意=直抒胸臆|直抒胸臆
各书己见=各抒己见|各抒己見
各纾己见=各抒己见|各抒己見
精诚所致=精诚所至|精誠所至
仁致义尽=仁至义尽|仁至義盡
无所不致=无所不至|無所不至
招至非议=招致非议|招致非議
专心至志=专心致志|專心致志
闲情逸志=闲情逸致|閒情逸致
妄费心机=枉费心机|枉費心機
妄自非薄=妄自菲薄|妄自菲薄
乌烟漳气=乌烟瘴气|烏煙瘴氣
乌烟脏气=乌烟瘴气|烏煙瘴氣
污合之众=乌合之众|烏合之眾
翁中捉鳖=瓮中捉鳖|瓮中捉鱉
翁声翁气=瓮声瓮气|瓮聲瓮氣
完壁归赵=完璧归赵|完璧歸趙
尾尾动听=娓娓动听|娓娓動聽
未雨筹缪=未雨绸缪|未雨綢繆
唯利事图=唯利是图|唯利是圖
五采缤纷=五彩缤纷|五彩繽紛
相形见拙=相行见绌|相行見絀
响彻云宵=响彻云霄|響徹雲霄
心狠手棘=心狠手辣|心狠手辣
心恢意懒=心灰意懒|心灰意懶
心恢意冷=心灰意冷|心灰意冷
殉私舞弊=徇私舞弊|徇私舞弊
殉情枉法=徇情枉法|徇情枉法
殉私枉法=徇私枉法|徇私枉法
以身徇国=以身殉国|以身殉國
循规蹈距=循规蹈矩|循規蹈矩
循规导距=循规蹈矩|循規蹈矩
循规导矩=循规蹈矩|循規蹈矩
诩诩如生=栩栩如生|栩栩如生
相题并论=相提并论|相提並論
笑容可鞠=笑容可掬|笑容可掬
嘻笑怒骂=嬉笑怒骂|嬉笑怒罵
文恬武嘻=文恬武嬉|文恬武嬉
嘻皮笑脸=嬉皮笑脸|嬉皮笑臉
书声朗朗=书声琅琅|書聲琅琅
惩前毙后=惩前毖后|懲前毖後
束手待毖=束手待毙|束手待斃
坐以待毖=坐以待毙|坐以待斃
爽心悦目=赏心悦目|賞心悅目
水火不融=水火不容|水火不容
水乳交溶=水乳交融|水乳交融
水泻不通=水泄不通|水泄不通
司空见怪=司空见惯|司空見慣
死皮癞脸=死皮赖脸|死皮賴臉
肆无忌怛=肆无忌怛|肆無忌怛
肆无忌殚=肆无忌殚|肆無忌殫
惮精竭虑=殚精竭虑|殫精竭慮
悚人听闻=耸人听闻|聳人聽聞
危言悚听=危言耸听|危言聳聽
毛骨耸然=毛骨悚然|毛骨悚然
随声附合=随声附和|隨聲附和
熟视无赌=熟视无睹|熟視無睹
善罢干休=善罢甘休|善罷甘休
侍强凌弱=恃强凌弱|恃強凌弱
持强凌弱=恃强凌弱|恃強凌弱
侍才傲物=恃才傲物|恃才傲物
持才傲物=恃才傲物|恃才傲物
有侍无恐=有恃无恐|有恃無恐
有持无恐=有恃无恐|有恃無恐
叹为观之=叹为观止|嘆為觀止
天翻地复=天翻地覆|天翻地覆
甜言密语=甜言蜜语|甜言蜜語
括不知耻=恬不知耻|恬不知恥
挑拨事非=挑拨是非|挑撥是非
同仇敌慨=同仇敌忾|同仇敵愾
投机捣把=投机倒把|投機倒把
逃之妖妖=逃之夭夭|逃之夭夭
投笔从绒=投笔从戎|投筆從戎
天衣无逢=天衣无缝|天衣無縫
蹈光养晦=韬光养晦|韜光養晦
挑肥捡瘦=挑肥拣瘦|挑肥揀瘦
披沙捡金=披沙拣金|披沙揀金
威靡不振=萎靡不振|萎靡不振
唯妙惟肖=惟妙惟肖|惟妙惟肖
生杀与夺=生杀予夺|生殺予奪
生死悠关=生死攸关|生死攸關
生死尤关=生死攸关|生死攸關
生死犹关=生死攸关|生死攸關
生死忧关=生死攸关|生死攸關
胜气凌人=盛气凌人|盛氣凌人
胜名难副=盛名难副|盛名難副
胜况空前=盛况空前|盛況空前
盛名难符=盛名难副|盛名難副
失口否认=矢口否认|矢口否認
食不裹腹=食不果腹|食不果腹
始终不逾=始终不渝|始終不渝
始终不遇=始终不渝|始終不渝
忠贞不逾=忠贞不渝|忠貞不渝
忠贞不遇=忠贞不渝|忠貞不渝
始作踊者=始作俑者|始作俑者
世外桃园=世外桃源|世外桃源
势均利敌=势均力敌|勢均力敵
势均力抵=势均力敌|勢均力敵
事得其反=适得其反|適得其反
试目以待=拭目以待|拭目以待
首当其充=首当其冲|首當其衝
手当其冲=首当其冲|首當其衝
受益非浅=受益匪浅|受益匪淺
受治于人=受制于人|受制於人
人才倍出=人才辈出|人才輩出
如出一澈=如出一辙|如出一轍
乳嗅未干=乳臭未干|乳臭未乾
三翻五次=三番五次|三番五次
三令五伸=三令五申|三令五申
森严壁磊=森严壁垒|森嚴壁壘
刹费苦心=煞费苦心|煞費苦心
杀费苦心=煞费苦心|煞費苦心
脸色刹白=脸色煞白|臉色煞白
脸色杀白=脸色煞白|臉色煞白
杀君夺位=弑君夺位|弒君奪位
沙漠绿州=沙漠绿洲|沙漠綠洲
插血为盟=歃血为盟|歃血為盟
山洪爆发=山洪暴发|山洪暴發
山青水秀=山清水秀|山清水秀
跚跚来迟=姗姗来迟|姍姍來遲
珊珊来迟=姗姗来迟|姍姍來遲
扇风点火=煽风点火|煽風點火
扇动暴乱=煽动暴乱|煽動暴亂
强词夺礼=强词夺理|強詞奪理
入情入礼=入情入理|入情入理
伤天害礼=伤天害理|傷天害理
天礼难容=天理难容|天理難容
通情达礼=通情达理|通情達理
心安礼得=心安理得|心安理得
彬彬有理=彬彬有礼|彬彬有禮
先理后兵=先礼后兵|先禮後兵
上窜下跳=上蹿下跳|上躥下跳
上吐下泄=上吐下泻|上吐下瀉
少安勿躁=稍安勿躁|稍安勿躁
梢安勿躁=稍安勿躁|稍安勿躁
捎安勿躁=稍安勿躁|稍安勿躁
少纵即逝=稍纵即逝|稍縱即逝
梢纵即逝=稍纵即逝|稍縱即逝
捎纵即逝=稍纵即逝|稍縱即逝
喜上眉捎=喜上眉梢|喜上眉梢
喜上眉稍=喜上眉梢|喜上眉梢
喜上眉少=喜上眉梢|喜上眉梢
伸东击西=声东击西|聲東擊西
身体利行=身体力行|身體力行
水利发电=水力发电|水力發電
自食其利=自食其力|自食其力
深居浅出=深居简出|深居簡出
神采弈弈=神采奕奕|神采奕奕
神智不清=神志不清|神志不清
苹水相逢=萍水相逢|萍水相逢
劈荆斩棘=披荆斩棘|披荊斬棘
砰然心动=怦然心动|怦然心動
破睇为笑=破涕为笑|破涕為笑
破斧沉舟=破釜沉舟|破釜沉舟
旁证博引=旁征博引|旁徵博引
攀龙付凤=攀龙附凤|攀龍附鳳
迫不急待=迫不及待|迫不及待
噬脐莫急=噬脐莫及|噬臍莫及
偏安一偶=偏安一隅|偏安一隅
负偶顽抗=负隅顽抗|負隅頑抗
向偶而泣=向隅而泣|向隅而泣
无独有隅=无独有偶|無獨有偶
迫在眉捷=迫在眉睫|迫在眉睫
千钩一发=千钧一发|千鈞一髮
千钓一发=千钧一发|千鈞一髮
前踞后恭=前倨后恭|前倨後恭
强驽之末=强弩之末|強弩之末
曲曲小事=区区小事|區區小事
磬竹难书=罄竹难书|罄竹難書
磐竹难书=罄竹难书|罄竹難書
轻歌慢舞=轻歌曼舞|輕歌曼舞
穷兵渎武=穷兵黩武|窮兵黷武
曲突徒薪=曲突徙薪|曲突徙薪
秋水依人=秋水伊人|秋水伊人
勤能补绌=勤能补拙|勤能補拙
其貌不洋=其貌不扬|其貌不揚
趋之若骛=趋之若鹜|趨之若鶩
恰如其份=恰如其分|恰如其分
如法泡制=如法炮制|如法炮製
礼上往来=礼尚往来|禮尚往來
流言非语=流言蜚语|流言蜚語
绿草如阴=绿草如茵|綠草如茵
绿草如荫=绿草如茵|綠草如茵
绿树成阴=绿树成荫|綠樹成蔭
绿阴蔽日=绿荫蔽日|綠蔭蔽日
龙飞风舞=龙飞凤舞|龍飛鳳舞
录录无为=碌碌无为|碌碌無為
庸庸录录=庸庸碌碌|庸庸碌碌
略胜一俦=略胜一筹|略勝一籌
廖廖无几=寥寥无几|寥寥無幾
麟次栉比=鳞次栉比|鱗次櫛比
良晨美景=良辰美景|良辰美景
落英宾纷=落英缤纷|落英繽紛
貌和神离=貌合神离|貌合神離
明辩是非=明辨是非|明辨是非
名列前矛=名列前茅|名列前茅
满目疮胰=满目疮痍|滿目瘡痍
弥天大慌=弥天大谎|彌天大謊
暝顽不灵=冥顽不灵|冥頑不靈
名负其实=名副其实|名副其實
名躁一时=名噪一时|名噪一時
明枪暗剑=明枪暗箭|明槍暗箭
暮然回首=蓦然回首|驀然回首
毛遂自茬=毛遂自荐|毛遂自薦
脑羞成怒=恼羞成怒|惱羞成怒
奴颜卑膝=奴颜婢膝|奴顏婢膝
摄手摄脚=蹑手蹑脚|躡手躡腳
弄巧成绌=弄巧成拙|弄巧成拙
讴心沥血=呕心沥血|嘔心瀝血
毗漏百出=纰漏百出|紕漏百出
批漏百出=纰漏百出|紕漏百出
刚复自用=刚愎自用|剛愎自用
刚腹自用=刚愎自用|剛愎自用
甘之如贻=甘之如饴|甘之如飴
鬼鬼崇崇=鬼鬼祟祟|鬼鬼祟祟
诂名钓誉=沽名钓誉|沽名釣譽
革故顶新=革故鼎新|革故鼎新
顶力相助=鼎力相助|鼎力相助
功亏一匮=功亏一篑|功虧一簣
根深底固=根深蒂固|根深蒂固
感恩带德=感恩戴德|感恩戴德
披星带月=披星戴月|披星戴月
披红带花=披红戴花|披紅戴花
带罪立功=戴罪立功|戴罪立功
鼓惑人心=蛊蛊人心|蠱蠱人心
鬼域伎俩=鬼蜮伎俩|鬼蜮伎倆
关怀倍至=关怀备至|關懷備至
推崇倍至=推崇备至|推崇備至
倍受欢迎=备受欢迎|備受歡迎
艰苦倍尝=艰苦备尝|艱苦備嘗
含辛如苦=含辛茹苦|含辛茹苦
轰堂大笑=哄堂大笑|哄堂大笑
火中取粟=火中取栗|火中取栗
虎视耽耽=虎视眈眈|虎視眈眈
海市辰楼=海市蜃楼|海市蜃樓
混身是胆=浑身是胆|渾身是膽
金榜提名=金榜题名|金榜題名
迥迥有神=炯炯有神|炯炯有神
鞠躬尽粹=鞠躬尽瘁|鞠躬盡瘁
鞠恭尽粹=鞠躬尽瘁|鞠躬盡瘁
鞠恭尽瘁=鞠躬尽瘁|鞠躬盡瘁
娇奢淫逸=骄奢淫逸|驕奢淫逸
娇阳似火=骄阳似火|驕陽似火
天之娇子=天之骄子|天之驕子
苦心孤旨=苦心孤诣|苦心孤詣
侩炙人口=脍炙人口|膾炙人口
口干舌躁=口干舌燥|口乾舌燥
恐前绝后=空前绝后|空前絕後
枯躁无味=枯燥无味|枯燥無味
开门缉盗=开门揖盗|開門揖盜
开门辑盗=开门揖盗|開門揖盜
打躬作缉=打躬作揖|打躬作揖
打躬作辑=打躬作揖|打躬作揖
鞠躬作缉=鞠躬作揖|鞠躬作揖
鞠躬作辑=鞠躬作揖|鞠躬作揖
烂竽充数=滥竽充数|濫竽充數
滥芋充数=滥竽充数|濫竽充數
肝脑途地=肝脑涂地|肝腦塗地
感人肺府=感人肺腑|感人肺腑
胸无城俯=胸无城府|胸無城府
肺腹之言=肺腑之言|肺腑之言
甘败下风=甘拜下风|甘拜下風
风声鹤戾=风声鹤唳|風聲鶴唳
凤毛鳞角=凤毛麟角|鳳毛麟角
斧底抽薪=釜底抽薪|釜底抽薪
赴烫蹈火=赴汤蹈火|赴湯蹈火
防微杜惭=防微杜渐|防微杜漸
风驰电制=风驰电掣|風馳電掣
付庸风雅=附庸风雅|附庸風雅
翻云复雨=翻云覆雨|翻雲覆雨
放任自留=放任自流|放任自流
大事大非=大是大非|大是大非
额首称庆=额手称庆|額手稱慶
繁文褥节=繁文缛节|繁文縟節
繁文溽节=繁文缛节|繁文縟節
法网灰灰=法网恢恢|法網恢恢
幅圆辽阔=幅员辽阔|幅員遼闊
发扬广大=发扬光大|發揚光大
丰功伟迹=丰功伟绩|豐功偉績
模范事绩=模范事迹|模範事跡
愤发图强=奋发图强|奮發圖強
惨绝人圜=惨绝人寰|慘絕人寰
惨绝人环=惨绝人寰|慘絕人寰
冲耳不闻=充耳不闻|充耳不聞
出而反尔=出尔反尔|出爾反爾
触膝谈心=促膝谈心|促膝談心
嵯跎岁月=蹉跎岁月|蹉跎歲月
卓卓有余=绰绰有余|綽綽有餘
痴心忘想=痴心妄想|痴心妄想
痴心枉想=痴心妄想|痴心妄想
叱诧风云=叱咤风云|叱吒風雲
吹毛求庇=吹毛求疵|吹毛求疵
吹毛求刺=吹毛求疵|吹毛求疵
唇枪舌箭=唇枪舌剑|唇槍舌劍
出神入画=出神入化|出神入化
大才小用=大材小用|大材小用
大名顶顶=大名鼎鼎|大名鼎鼎
淡装浓抹=淡妆浓抹|淡妝濃抹
梳装打扮=梳妆打扮|梳妝打扮
暗然失色=黯然失色|黯然失色
安帮定国=安邦定国|安邦定國
哀声叹气=唉声叹气|唉聲嘆氣
按步就班=按部就班|按部就班
搬门弄斧=班门弄斧|班門弄斧
拔山涉水=跋山涉水|跋山涉水
衫衫有礼=彬彬有礼|彬彬有禮
彼彼皆是=比比皆是|比比皆是
不寒而粟=不寒而栗|不寒而慄
兵慌马乱=兵荒马乱|兵荒馬亂
搏大精深=博大精深|博大精深
不齿下问=不耻下问|不恥下問
不娇不躁=不骄不躁|不驕不躁
别出机抒=别出机杼|別出機杼
仓惶失措=仓皇失措|倉皇失措
仓慌失措=仓皇失措|倉皇失措
苍海一粟=沧海一粟|滄海一粟
草管人命=草菅人命|草菅人命
草官人命=草菅人命|草菅人命
残无人道=惨无人道|慘無人道
残羹冷灸=残羹冷炙|殘羹冷炙
捡肥拣瘦=拣肥拣瘦|揀肥揀瘦
倾刻间=顷刻之间|頃刻之間
#站粟=站栗|站[栗慄]
天然汽=天然气|天然氣
煤汽机=煤气机|煤氣機
燃汽机=燃气机|燃氣機
蒸气机=蒸汽机|蒸汽機
文诌诌=文绉绉|文縐縐
引伸义=引申义|引申義
坐右铭=座右铭|座右銘
下功夫=下工夫|下工夫
造事者=肇事者|肇事者
暖哄哄=暖烘烘|暖烘烘
雄纠纠=雄赳赳|雄赳赳
冷不妨=冷不防|冷不防
名信片=明信片|明信片
过度到=过渡到|過渡到
皎皎者=佼佼者|佼佼者
财物科=财务科|財務科
泊来品=舶来品|舶來品
挖墙角=挖墙脚|挖牆腳
钉书机=订书机|訂書機
订扣子=钉扣子|釘扣子
萤光屏=荧光屏|熒光屏
萤光棒=荧光棒|熒光棒
荧火虫=萤火虫|螢火蟲
年青人=年轻人|年輕人
热坑头=热炕头|熱炕頭
手溜弹=手榴弹|手榴彈
北美州=北美洲|北美洲
南美州=南美洲|南美洲
大洋州=大洋洲|大洋洲
南极州=南极洲|南極洲
性情燥=性情躁|性情躁
性情噪=性情躁|性情躁
漫性子=慢性子|慢性子
曼性子=慢性子|慢性子
漫动作=慢动作|慢動作
曼动作=慢动作|慢動作
漫腾腾=慢腾腾|慢騰騰
曼腾腾=慢腾腾|慢騰騰
漫吞吞=慢吞吞|慢吞吞
曼吞吞=慢吞吞|慢吞吞
漫悠悠=慢悠悠|慢悠悠
曼悠悠=慢悠悠|慢悠悠
漫漫地=慢慢地|慢慢地
曼曼地=慢慢地|慢慢地
路慢慢=路漫漫|路漫漫
夜慢慢=夜漫漫|夜漫漫
路曼慢=路漫漫|路漫漫
夜曼慢=夜漫漫|夜漫漫
路慢曼=路漫漫|路漫漫
夜慢曼=夜漫漫|夜漫漫
路曼曼=路漫漫|路漫漫
夜曼曼=夜漫漫|夜漫漫
影牒机=影碟机|影碟機
番跟斗=翻跟斗|翻跟斗
幅作用=副作用|副作用
幅教授=副教授|副教授
幅标题=副标题|副標題
幅产品=副产品|副產品
电线干=电线杆|電線桿
电线竿=电线杆|電線桿
钓鱼干=钓鱼竿|釣魚竿
钓鱼杆=钓鱼竿|釣魚竿
糊萝卜=胡萝卜|胡蘿蔔
作生意=做生意|做生意
作功课=做功课|做功課
作文章=做文章|做文章
作买卖=做买卖|做買賣
作鬼脸=做鬼脸|做鬼臉
爆发户=暴发户|暴發戶
黏上去=粘上去|粘上去
缴作业=交作业|交作業
工程帅=工程师|工程師
券裤腿=卷裤腿|卷褲腿
券地皮=卷地皮|卷地皮
券铺盖=卷铺盖|卷鋪蓋
国库卷=国库券|國庫券
入场卷=入场券|入場券
泌人心=沁人心|沁人心
侯选人=候选人|候選人
捡两种=拣两种|揀兩種
度过难关=渡过|渡過
度过困难=渡过|渡過
漫吞腾=慢吞|慢吞
曼吞腾=慢吞|慢吞
漫腾吞=慢腾|慢騰
曼腾吞=慢腾|慢騰
消毁=销毁|銷毀
开消=开销|開銷
弘亮=洪亮|洪亮
定婚=订婚|訂婚
神彩=神采|神采
文彩=文采|文采
风彩=风采|風采
我门=我们|我們
你门=你们|你們
他门=他们|他們
咱门=咱们|咱們
俺门=俺们|俺們
脉膊=脉搏|脈搏
脉博=脉搏|脈搏
赤博=赤膊|赤膊
爱带=爱戴|愛戴
拥带=拥戴|擁戴
白晰=白皙|白皙
报筹=报酬|報酬
卑却=卑怯|卑怯
恶耗=噩耗|噩耗
材华=才华|才華
雄材=雄才|雄才
喝采=喝彩|喝彩
翱游=遨游|遨游
遨翔=翱翔|翱翔
娘两=娘俩|娘倆
更叠=更迭|更迭
重迭=重叠|重疊
起迄=起讫|起訖
雕彻=雕砌|雕砌
沾辱=玷辱|玷辱
沾污=玷污|玷污
中裁=仲裁|仲裁
仲栽=仲裁|仲裁
中栽=仲裁|仲裁
陷井=陷阱|陷阱
劈谣=辟谣|闢謠
梦餍=梦魇|夢魘
缈视=藐视|藐視
募然=蓦然|驀然
描模=描摹|描摹
按磨=按摩|按摩
观磨=观摩|觀摩
临摩=临摹|臨摹
蓦捐=募捐|募捐
通辑=通缉|通緝
杂踏=杂沓|雜沓
疏峻=疏浚|疏浚
疏竣=疏浚|疏浚
撕杀=厮杀|廝殺
贮立=伫立|佇立
绉纹=皱纹|皺紋
躁热=燥热|燥熱
肿涨=肿胀|腫脹
羁靡=羁縻|羈縻
羁糜=羁縻|羈縻
奢糜=奢靡|奢靡
奢縻=奢靡|奢靡
呕气=怄气|慪氣
欧打=殴打|毆打
斗欧=斗殴|鬥毆
亵赎=亵渎|褻瀆
恢谐=诙谐|詼諧
渲泄=宣泄|宣泄
宣染=渲染|渲染
延申=延伸|延伸
毗临=毗邻|毗鄰
骠悍=剽悍|剽悍
永决=永诀|永訣
座落=坐落|坐落
幅射=辐射|輻射
煤碳=煤炭|煤炭
编篡=编纂|編纂
蜇居=蛰居|蟄居
蜇伏=蛰伏|蟄伏
海蛰=海蜇|海蜇
和霭=和蔼|和藹
安份=安分|安分
本份=本分|本分
份内=分内|分內
按装=安装|安裝
浪废=浪费|浪費
明片=名片|名片
国萃=国粹|國粹
精萃=精粹|精粹
尉蓝=蔚蓝|蔚藍
渡假=度假|度假
贯输=灌输|灌輸
刻划=刻画|刻畫
挤身=跻身|躋身
勘平=戡平|戡平
打腊=打蜡|打蠟
蜡梅=腊梅|臘梅
流览=浏览|瀏覽
盖戮=盖戳|蓋戳
戮穿=戳穿|戳穿
屠戳=屠戮|屠戮
沉缅=沉湎|沉湎
湎怀=缅怀|緬懷
瞑思=冥思|冥思
溟思=冥思|冥思
瞑想=冥想|冥想
溟想=冥想|冥想
凭添=平添|平添
扑素=朴素|樸素
仆素=朴素|樸素
奇倔=奇崛|奇崛
压诈=压榨|壓榨
誉写=誊写|謄寫
涂毒=荼毒|荼毒
新颍=新颖|新穎
圆丁=园丁|園丁
圆林=园林|園林
圆艺=园艺|園藝
圆地=园地|園地
肆业=肄业|肄業
延袭=沿袭|沿襲
粗旷=粗犷|粗獷
嬴弱=羸弱|羸弱
布署=部署|部署
布暑=部署|部署
部暑=部署|部署
付食=副食|副食
商确=商榷|商榷
漫骂=谩骂|謾罵
供献=贡献|貢獻
报歉=抱歉|抱歉
报怨=抱怨|抱怨
扫瞄=扫描|掃描
装桢=装帧|裝幀
痉孪=痉挛|痙攣
罗唆=啰唆|囉唆
装钉=装订|裝訂
亲睐=青睐|青睞
轻青=轻年|輕年
污告=诬告|誣告
担搁=耽搁|耽擱
拼揍=拼凑|拼湊
恐布=恐怖|恐怖
惨酷=残酷|殘酷
浮浅=肤浅|膚淺
清彻=清澈|清澈
到是=倒是|倒是
吭害=坑害|坑害
脉胳=脉络|脈絡
了草=潦草|潦草
规距=规矩|規矩
题纲=提纲|提綱
婉惜=惋惜|惋惜
慎密=缜密|縝密
会悟=会晤|會晤
晏会=宴会|宴會
敷演=敷衍|敷衍
竭见=谒见|謁見
咀咒=诅咒|詛咒
扎记=札记|札記
贬眼=眨眼|眨眼
洽巧=恰巧|恰巧
洽似=恰似|恰似
洽当=恰当|恰當
洽好=恰好|恰好
洽恰=恰恰|恰恰
恰谈=洽谈|洽談
恰商=洽商|洽商
恰办=洽办|洽辦
恰购=洽购|洽購
面恰=面洽|面洽
接恰=接洽|接洽
融恰=融洽|融洽
纱尘=沙尘|沙塵
砂尘=沙尘|沙塵
纱丘=沙丘|沙丘
砂丘=沙丘|沙丘
纱滩=沙滩|沙灘
砂滩=沙滩|沙灘
纱鸥=沙鸥|沙鷗
砂鸥=沙鸥|沙鷗
纱哑=沙哑|沙啞
砂哑=沙哑|沙啞
纱发=沙发|沙發
砂发=沙发|沙發
纱龙=沙龙|沙龍
砂龙=沙龙|沙龍
纱盘=沙盘|沙盤
砂盘=沙盘|沙盤
沙窗=纱窗|紗窗
砂窗=纱窗|紗窗
沙线=纱线|紗線
砂线=纱线|紗線
沙巾=纱巾|紗巾
砂巾=纱巾|紗巾
沙轮=砂轮|砂輪
纱轮=砂轮|砂輪
沙纸=砂纸|砂紙
纱纸=砂纸|砂紙
朱沙=朱砂|朱砂
帖金=贴金|貼金
帖近=贴近|貼近
帖紧=贴紧|貼緊
帖切=贴切|貼切
帖心=贴心|貼心
帖息=贴息|貼息
帖现=贴现|貼現
帖补=贴补|貼補
帖板=贴板|貼板
帖边=贴边|貼邊
帖身=贴身|貼身
帖着=贴着|貼著
张帖=张贴|張貼
粘帖=粘贴|粘貼
补帖=补贴|補貼
津帖=津贴|津貼
倒帖=倒贴|倒貼
紧帖=紧贴|緊貼
碑贴=碑帖|碑帖
画贴=画帖|畫帖
请贴=请帖|請帖
回贴=回帖|回帖
服贴=服帖|服帖
妥贴=妥帖|妥帖
喜贴=喜帖|喜帖
昧道=味道|味道
昧精=味精|味精
昧感=味感|味感
气昧=气味|氣味
兴昧=兴味|興味
趣昧=趣味|趣味
意昧=意味|意味
韵昧=韵味|韻味
体昧=体味|體味
滋昧=滋味|滋味
寻昧=寻味|尋味
蒙味=蒙昧|蒙昧
暧味=暧昧|曖昧
冒味=冒昧|冒昧
祥细=详细|詳細
祥尽=详尽|詳盡
祥谈=详谈|詳談
祥情=详情|詳情
祥实=详实|詳實
祥略=详略|詳略
周祥=周详|周詳
安祥=安详|安詳
吉详=吉祥|吉祥
详和=祥和|祥和
详瑞=祥瑞|祥瑞
详云=祥云|祥雲
详麟=祥麟|祥麟
霄夜=宵夜|宵夜
霄禁=宵禁|宵禁
霄旰=宵旰|宵旰
夜霄=夜宵|夜宵
春霄=春宵|春宵
通霄=通宵|通宵
元霄=元宵|元宵
云宵=云霄|雲霄
九宵=九霄|九霄
重宵=重霄|重霄
凌宵=凌霄|凌霄
型状=形状|形狀
型体=形体|形體
型容=形容|形容
型态=形态|形態
型迹=形迹|形跡
型势=形势|形勢
型象=形象|形象
条型=条形|條形
方型=方形|方形
圆型=圆形|圓形
球型=球形|球形
地型=地形|地形
情型=情形|情形
现型=现形|現形
无型=无形|無形
形号=型号|型號
形砂=型砂|型砂
类形=类型|類型
新形=新型|新型
砂形=砂型|砂型
模形=模型|模型
造形=造型|造型
暄哗=喧哗|喧嘩
暄闹=喧闹|喧鬧
暄嚣=喧嚣|喧囂
暄嚷=喧嚷|喧嚷
暄扰=喧扰|喧擾
暄笑=喧笑|喧笑
暄杂=喧杂|喧雜
暄噪=喧噪|喧噪
寒喧=寒暄|寒暄
口绎=口译|口譯
笔绎=笔译|筆譯
意绎=意译|意譯
直绎=直译|直譯
翻绎=翻译|翻譯
演译=演绎|演繹
鱼业=渔业|漁業
鱼翁=渔翁|漁翁
鱼村=渔村|漁村
鱼船=渔船|漁船
鱼民=渔民|漁民
鱼歌=渔歌|漁歌
鱼夺=渔夺|漁奪
鱼利=渔利|漁利
鱼色=渔色|漁色
鱼火=渔火|漁火
萤白=莹白|瑩白
萤澈=莹澈|瑩澈
萤洁=莹洁|瑩潔
晶萤=晶莹|晶瑩
莹火=萤火|螢火
莹石=萤石|螢石
莹幕=萤幕|螢幕
洲郡=州郡|州郡
洲县=州县|州縣
苏洲=苏州|蘇州
杭洲=杭州|杭州
州际=洲际|洲際
欧州=欧洲|歐洲
亚州=亚洲|亞洲
非州=非洲|非洲
大州=大洲|大洲
沙州=沙洲|沙洲
帐本=账本|賬本
帐簿=账簿|賬簿
帐册=账册|賬冊
帐单=账单|賬單
帐房=账房|賬房
帐号=账号|賬號
帐户=账户|賬戶
帐款=账款|賬款
帐目=账目|賬目
欠帐=欠账|欠賬
账幕=帐幕|帳幕
账篷=帐篷|帳篷
床账=床帐|床帳
蚊账=蚊帐|蚊帳
噪动=躁动|躁動
燥动=躁动|躁動
噪进=躁进|躁進
燥进=躁进|躁進
噪狂=躁狂|躁狂
燥狂=躁狂|躁狂
急燥=急躁|急躁
浮燥=浮躁|浮躁
骄燥=骄躁|驕躁
烦燥=烦躁|煩躁
暴燥=暴躁|暴躁
急噪=急躁|急躁
浮噪=浮躁|浮躁
骄噪=骄躁|驕躁
烦噪=烦躁|煩躁
暴噪=暴躁|暴躁
燥声=噪声|噪聲
躁声=噪声|噪聲
燥音=噪音|噪音
躁音=噪音|噪音
燥嚷=噪嚷|噪嚷
躁嚷=噪嚷|噪嚷
燥杂=噪杂|噪雜
躁杂=噪杂|噪雜
噪裂=燥裂|燥裂
躁裂=燥裂|燥裂
噪热=燥热|燥熱
干噪=干燥|乾燥
枯噪=枯燥|枯燥
干躁=干燥|乾燥
枯躁=枯燥|枯燥
分脏=分赃|分贓
栽脏=栽赃|栽贓
销脏=销赃|銷贓
炼笔=练笔|練筆
拣笔=练笔|練筆
炼兵=练兵|練兵
拣兵=练兵|練兵
炼达=练达|練達
拣达=练达|練達
炼功=练功|練功
拣功=练功|練功
炼武=练武|練武
拣武=练武|練武
炼习=练习|練習
拣习=练习|練習
训炼=训练|訓練
老炼=老练|老練
熟炼=熟练|熟練
干炼=干练|幹練
训拣=训练|訓練
老拣=老练|老練
熟拣=熟练|熟練
干拣=干练|幹練
练丹=炼丹|煉丹
拣丹=炼丹|煉丹
练钢=炼钢|煉鋼
拣钢=炼钢|煉鋼
练铁=炼铁|煉鐵
拣铁=炼铁|煉鐵
练焦=炼焦|煉焦
拣焦=炼焦|煉焦
练乳=炼乳|煉乳
拣乳=炼乳|煉乳
练油=炼油|煉油
拣油=炼油|煉油
练狱=炼狱|煉獄
拣狱=炼狱|煉獄
冶练=冶炼|冶煉
冶拣=冶炼|冶煉
挑练=挑拣|挑揀
挑炼=挑拣|挑揀
粱山=梁山|梁山
房粱=房梁|房梁
桥粱=桥梁|橋梁
山粱=山梁|山梁
津粱=津梁|津梁
鼻粱=鼻梁|鼻梁
梁肉=粱肉|粱肉
鳞角=麟角|麟角
金鳞=金麟|金麟
麒鳞=麒麟|麒麟
履盖=覆盖|覆蓋
履裹=覆裹|覆裹
履罩=覆罩|覆罩
履灭=覆灭|覆滅
履没=覆没|覆沒
履压=覆压|覆壓
履问=覆问|覆問
履亡=覆亡|覆亡
履庇=覆庇|覆庇
履辙=覆辙|覆轍
履手=覆手|覆手
履水=覆水|覆水
履信=覆信|覆信
履函=覆函|覆函
履音=覆音|覆音
履案=覆案|覆案
履国=覆国|覆國
履邦=覆邦|覆邦
履杯=覆杯|覆杯
颠履=颠覆|顛覆
覆任=履任|履任
覆带=履带|履帶
覆历=履历|履歷
覆践=履践|履踐
覆行=履行|履行
覆约=履约|履約
漫待=慢待|慢待
曼待=慢待|慢待
漫走=慢走|慢走
曼走=慢走|慢走
漫性=慢性|慢性
曼性=慢性|慢性
漫行=慢行|慢行
曼行=慢行|慢行
慢长=漫长|漫長
曼长=漫长|漫長
慢画=漫画|漫畫
曼画=漫画|漫畫
慢谈=漫谈|漫談
曼谈=漫谈|漫談
慢言=漫言|漫言
曼言=漫言|漫言
弥慢=弥漫|彌漫
迷慢=迷漫|迷漫
弥曼=弥漫|彌漫
迷曼=迷漫|迷漫
慢妙=曼妙|曼妙
漫妙=曼妙|曼妙
慢丽=曼丽|曼麗
漫丽=曼丽|曼麗
慢声=曼声|曼聲
漫声=曼声|曼聲
棉延=绵延|綿延
棉亘=绵亘|綿亘
棉羊=绵羊|綿羊
棉薄=绵薄|綿薄
连棉=连绵|連綿
绵花=棉花|棉花
绵桃=棉桃|棉桃
绵药=棉药|棉藥
绵签=棉签|棉簽
绵衣=棉衣|棉衣
绵裤=棉裤|棉褲
绵袄=棉袄|棉襖
绵被=棉被|棉被
绵鞋=棉鞋|棉鞋
绵絮=棉絮|棉絮
缈远=渺远|渺遠
缈茫=渺茫|渺茫
缈小=渺小|渺小
缥渺=缥缈|縹緲
漂扬=飘扬|飄揚
缥扬=飘扬|飄揚
漂摆=飘摆|飄擺
缥摆=飘摆|飄擺
漂洒=飘洒|飄灑
缥洒=飘洒|飄灑
漂逸=飘逸|飄逸
缥逸=飘逸|飄逸
漂摇=飘摇|飄搖
缥摇=飘摇|飄搖
漂零=飘零|飄零
缥零=飘零|飄零
漂带=飘带|飄帶
缥带=飘带|飄帶
幕色=暮色|暮色
慕色=暮色|暮色
募色=暮色|暮色
幕霭=暮霭|暮靄
慕霭=暮霭|暮靄
募霭=暮霭|暮靄
幕雨=暮雨|暮雨
慕雨=暮雨|暮雨
募雨=暮雨|暮雨
暮布=幕布|幕布
慕布=幕布|幕布
募布=幕布|幕布
暮府=幕府|幕府
慕府=幕府|幕府
募府=幕府|幕府
夜暮=夜幕|夜幕
开暮=开幕|開幕
银暮=银幕|銀幕
帷暮=帷幕|帷幕
夜慕=夜幕|夜幕
开慕=开幕|開幕
银慕=银幕|銀幕
帷慕=帷幕|帷幕
夜募=夜幕|夜幕
开募=开幕|開幕
银募=银幕|銀幕
帷募=帷幕|帷幕
暮名=慕名|慕名
幕名=慕名|慕名
募名=慕名|慕名
仰暮=仰慕|仰慕
羡暮=羡慕|羡慕
爱暮=爱慕|愛慕
思暮=思慕|思慕
仰幕=仰慕|仰慕
羡幕=羡慕|羡慕
爱幕=爱慕|愛慕
思幕=思慕|思慕
仰募=仰慕|仰慕
羡募=羡慕|羡慕
爱募=爱慕|愛慕
思募=思慕|思慕
暮集=募集|募集
幕集=募集|募集
慕集=募集|募集
暮捐=募捐|募捐
幕捐=募捐|募捐
慕捐=募捐|募捐
暮款=募款|募款
幕款=募款|募款
慕款=募款|募款
招暮=招募|招募
征暮=征募|徵募
招幕=招募|招募
征幕=征募|徵募
招慕=招募|招募
征慕=征募|徵募
谜信=迷信|迷信
谜糊=迷糊|迷糊
谜津=迷津|迷津
谜蒙=迷蒙|迷蒙
谜离=迷离|迷離
谜惑=迷惑|迷惑
谜恋=迷恋|迷戀
谜途=迷途|迷途
谜宫=迷宫|迷宮
谜魂=迷魂|迷魂
谜路=迷路|迷路
谜失=迷失|迷失
谜雾=迷雾|迷霧
球谜=球迷|球迷
书谜=书迷|書迷
棋谜=棋迷|棋迷
车谜=车迷|車迷
影谜=影迷|影迷
歌谜=歌迷|歌迷
戏谜=戏迷|戲迷
迷语=谜语|謎語
迷底=谜底|謎底
迷团=谜团|謎團
灯迷=灯谜|燈謎
猜迷=猜谜|猜謎
哑迷=哑谜|啞謎
字迷=字谜|字謎
脑恨=恼恨|惱恨
脑怒=恼怒|惱怒
脑火=恼火|惱火
烦脑=烦恼|煩惱
苦脑=苦恼|苦惱
懊脑=懊恼|懊惱
恼子=脑子|腦子
恼袋=脑袋|腦袋
恼壳=脑壳|腦殼
恼门=脑门|腦門
恼瓜=脑瓜|腦瓜
恼髓=脑髓|腦髓
恼浆=脑浆|腦漿
恼筋=脑筋|腦筋
恼海=脑海|腦海
恼力=脑力|腦力
人恼=人脑|人腦
电恼=电脑|電腦
樟恼=樟脑|樟腦
帐蓬=帐篷|帳篷
车蓬=车篷|車篷
船蓬=船篷|船篷
篷门=蓬门|蓬門
篷松=蓬松|蓬鬆
篷乱=蓬乱|蓬亂
篷头=蓬头|蓬頭
篷勃=蓬勃|蓬勃
篷蒿=蓬蒿|蓬蒿
篷荜=蓬荜|蓬蓽
篷莱=蓬莱|蓬萊
莲篷=莲蓬|蓮蓬
猾冰=滑冰|滑冰
猾步=滑步|滑步
猾车=滑车|滑車
猾道=滑道|滑道
猾动=滑动|滑動
猾竿=滑竿|滑竿
猾稽=滑稽|滑稽
猾梯=滑梯|滑梯
猾行=滑行|滑行
枕籍=枕藉|枕藉
蕴籍=蕴藉|蘊藉
慰籍=慰藉|慰藉
狼籍=狼藉|狼藉
书藉=书籍|書籍
典藉=典籍|典籍
户藉=户籍|戶籍
国藉=国籍|國籍
学藉=学籍|學籍
藉贯=籍贯|籍貫
藉没=籍没|籍沒
毕竞=毕竟|畢竟
竞至=竟至|竟至
竞日=竟日|竟日
竞而=竟而|竟而
竟渡=竞渡|競渡
竟技=竞技|競技
竟赛=竞赛|競賽
竟选=竞选|競選
竟争=竞争|競爭
竟走=竞走|競走
即定=既定|既定
即而=既而|既而
即是=既是|既是
即往=既往|既往
即有=既有|既有
即然=既然|既然
既日=即日|即日
既刻=即刻|即刻
既景=即景|即景
既便=即便|即便
既将=即将|即將
既使=即使|即使
既若=即若|即若
既位=即位|即位
既兴=即兴|即興
既行=即行|即行
在既=在即|在即
立既=立即|立即
俱备=具备|具備
俱有=具有|具有
俱结=具结|具結
俱名=具名|具名
俱体=具体|具體
家俱=家具|家具
具全=俱全|俱全
具兴=俱兴|俱興
峻杰=俊杰|俊傑
竣杰=俊杰|俊傑
骏杰=俊杰|俊傑
峻丽=俊丽|俊麗
竣丽=俊丽|俊麗
骏丽=俊丽|俊麗
峻美=俊美|俊美
竣美=俊美|俊美
骏美=俊美|俊美
峻秀=俊秀|俊秀
竣秀=俊秀|俊秀
骏秀=俊秀|俊秀
峻雅=俊雅|俊雅
竣雅=俊雅|俊雅
骏雅=俊雅|俊雅
峻逸=俊逸|俊逸
竣逸=俊逸|俊逸
骏逸=俊逸|俊逸
峻伟=俊伟|俊偉
竣伟=俊伟|俊偉
骏伟=俊伟|俊偉
峻俏=俊俏|俊俏
竣俏=俊俏|俊俏
骏俏=俊俏|俊俏
英峻=英俊|英俊
才峻=才俊|才俊
英竣=英俊|英俊
才竣=才俊|才俊
俊拔=峻拔|峻拔
竣拔=峻拔|峻拔
骏拔=峻拔|峻拔
俊笔=峻笔|峻筆
竣笔=峻笔|峻筆
骏笔=峻笔|峻筆
俊刻=峻刻|峻刻
竣刻=峻刻|峻刻
骏刻=峻刻|峻刻
俊直=峻直|峻直
竣直=峻直|峻直
骏直=峻直|峻直
俊峭=峻峭|峻峭
竣峭=峻峭|峻峭
骏峭=峻峭|峻峭
峻工=竣工|竣工
骏工=竣工|竣工
俊工=竣工|竣工
峻马=骏马|駿馬
竣马=骏马|駿馬
兰桥=蓝桥|藍橋
篮桥=蓝桥|藍橋
兰天=蓝天|藍天
篮天=蓝天|藍天
兰田=蓝田|藍田
篮田=蓝田|藍田
兰玉=蓝玉|藍玉
篮玉=蓝玉|藍玉
兰图=蓝图|藍圖
篮图=蓝图|藍圖
兰皮=蓝皮|藍皮
篮皮=蓝皮|藍皮
兰本=蓝本|藍本
篮本=蓝本|藍本
蓝若=兰若|蘭若
篮若=兰若|蘭若
蓝言=兰言|蘭言
篮言=兰言|蘭言
蓝谱=兰谱|蘭譜
篮谱=兰谱|蘭譜
蓝章=兰章|蘭章
篮章=兰章|蘭章
兰筐=篮筐|籃筐
蓝筐=篮筐|籃筐
兰球=篮球|籃球
蓝球=篮球|籃球
兰子=篮子|籃子
蓝子=篮子|籃子
投兰=投篮|投籃
网兰=网篮|網籃
竹兰=竹篮|竹籃
藤兰=藤篮|藤籃
花兰=花篮|花籃
投蓝=投篮|投籃
网蓝=网篮|網籃
竹蓝=竹篮|竹籃
藤蓝=藤篮|藤籃
花蓝=花篮|花籃
仁参=人参|人參
人仁=仁人|仁人
妨范=防范|防範
妨卫=防卫|防衛
防碍=妨碍|妨礙
番案=翻案|翻案
番译=翻译|翻譯
反工=返工|返工
幅食=副食|副食
幅业=副业|副業
副度=幅度|幅度
副员=幅员|幅員
干菌=杆菌|桿菌
干秤=杆秤|桿秤
桅干=桅杆|桅桿
桅竿=桅杆|桅桿
鱼干=鱼竿|魚竿
鱼杆=鱼竿|魚竿
刚笔=钢笔|鋼筆
刚板=钢板|鋼板
刚鞭=钢鞭|鋼鞭
刚材=钢材|鋼材
刚管=钢管|鋼管
刚筋=钢筋|鋼筋
刚琴=钢琴|鋼琴
刚丝=钢丝|鋼絲
刚铁=钢铁|鋼鐵
刚纸=钢纸|鋼紙
刚水=钢水|鋼水
胡剂=糊剂|糊劑
胡精=糊精|糊精
胡口=糊口|糊口
糊须=胡须|鬍鬚
糊吹=胡吹|胡吹
糊匪=胡匪|胡匪
糊混=胡混|胡混
糊乱=胡乱|胡亂
糊闹=胡闹|胡鬧
糊说=胡说|胡說
振惊=震惊|震驚
振吓=震吓|震嚇
振怒=震怒|震怒
振慑=震慑|震懾
振撼=震撼|震撼
震动=振动|振動
震奋=振奋|振奮
坐位=座位|座位
座标=坐标|坐標
遵敬=尊敬|尊敬
遵重=尊重|尊重
遵称=尊称|尊稱
遵奉=尊奉|尊奉
尊守=遵守|遵守
尊循=遵守|遵守
作官=做官|做官
作戏=做戏|做戲
做画=作画|作畫
做文=作文|作文
做业=作业|作業
做风=作风|作風
做品=作品|作品
做者=作者|作者
拌脚=绊脚|絆腳
拌倒=绊倒|絆倒
拌住=绊住|絆住
羁拌=羁绊|羈絆
曝露=暴露|暴露
曝晒=暴晒|暴晒
曝君=暴君|暴君
爆君=暴君|暴君
曝力=暴力|暴力
爆力=暴力|暴力
曝风=暴风|暴風
爆风=暴风|暴風
曝雨=暴雨|暴雨
爆雨=暴雨|暴雨
曝雪=暴雪|暴雪
爆雪=暴雪|暴雪
爆露=暴露|暴露
曝漏=暴漏|暴漏
爆漏=暴漏|暴漏
曝掠=暴掠|暴掠
爆掠=暴掠|暴掠
曝跌=暴跌|暴跌
爆跌=暴跌|暴跌
曝乱=暴乱|暴亂
爆乱=暴乱|暴亂
曝虐=暴虐|暴虐
爆虐=暴虐|暴虐
曝殄=暴殄|暴殄
爆殄=暴殄|暴殄
曝躁=暴躁|暴躁
爆躁=暴躁|暴躁
曝病=暴病|暴病
爆病=暴病|暴病
曝光=暴光|暴光
爆光=暴光|暴光
曝利=暴利|暴利
爆利=暴利|暴利
爆晒=暴晒|暴晒
曝民=暴民|暴民
爆民=暴民|暴民
曝涨=暴涨|暴漲
爆涨=暴涨|暴漲
曝怒=暴怒|暴怒
爆怒=暴怒|暴怒
曝行=暴行|暴行
爆行=暴行|暴行
曝戾=暴戾|暴戾
爆戾=暴戾|暴戾
曝政=暴政|暴政
爆政=暴政|暴政
曝尸=暴尸|暴屍
爆尸=暴尸|暴屍
曝徒=暴徒|暴徒
爆徒=暴徒|暴徒
曝卒=暴卒|暴卒
爆卒=暴卒|暴卒
曝富=暴富|暴富
爆富=暴富|暴富
曝动=暴动|暴動
爆动=暴动|暴動
暴发=爆发|爆發
暴破=爆破|爆破
曝破=爆破|爆破
暴满=爆满|爆滿
曝满=爆满|爆滿
暴裂=爆裂|爆裂
曝裂=爆裂|爆裂
暴棚=爆棚|爆棚
曝棚=爆棚|爆棚
暴冷=爆冷|爆冷
曝冷=爆冷|爆冷
暴笑=爆笑|爆笑
曝笑=爆笑|爆笑
暴炒=爆炒|爆炒
曝炒=爆炒|爆炒
暴汁=爆汁|爆汁
曝汁=爆汁|爆汁
暴料=爆料|爆料
曝料=爆料|爆料
暴灯=爆灯|爆燈
曝灯=爆灯|爆燈
暴款=爆款|爆款
曝款=爆款|爆款
暴肚=爆肚|爆肚
曝肚=爆肚|爆肚
暴胎=爆胎|爆胎
曝胎=爆胎|爆胎
暴表=爆表|爆表
曝表=爆表|爆表
曝发=爆发|爆發
暴炸=爆炸|爆炸
曝炸=爆炸|爆炸
暴光=曝光|曝光
彩访=采访|採訪
彩伐=采伐|採伐
彩集=采集|採集
彩收=采收|採收
彩购=采购|採購
彩取=采取|採取
彩选=采选|採選
彩矿=采矿|採礦
彩药=采药|採藥
彩木=采木|採木
采虹=彩虹|彩虹
采笔=彩笔|彩筆
采绸=彩绸|彩綢
采色=彩色|彩色
采灯=彩灯|彩燈
采画=彩画|彩畫
采票=彩票|彩票
采电=彩电|彩電
采排=彩排|彩排
采带=彩带|彩帶
精采=精彩|精彩
疾弛=疾驰|疾馳
奔弛=奔驰|奔馳
松驰=松弛|鬆弛
刻簙=刻薄|刻薄
轻簙=轻薄|輕薄
甲版=甲板|甲板
画版=画板|畫板
篮版=篮板|籃板
黑版=黑板|黑板
甲扳=甲板|甲板
画扳=画板|畫板
篮扳=篮板|籃板
黑扳=黑板|黑板
版手=扳手|扳手
板手=扳手|扳手
版倒=扳倒|扳倒
板倒=扳倒|扳倒
辨证=辩证|辯證
辩别=辨别|辨別
辫别=辨别|辨別
瓣别=辨别|辨別
辩子=辫子|辮子
辨子=辫子|辮子
瓣子=辫子|辮子
花辩=花瓣|花瓣
豆辩=豆瓣|豆瓣
蒜辩=蒜瓣|蒜瓣
花辨=花瓣|花瓣
豆辨=豆瓣|豆瓣
蒜辨=蒜瓣|蒜瓣
花辫=花瓣|花瓣
豆辫=豆瓣|豆瓣
蒜辫=蒜瓣|蒜瓣
辩析=辨析|辨析
抵砺=砥砺|砥礪
霎车=刹车|剎車
踏方=塌方|塌方
蹋方=塌方|塌方
倒踏=倒塌|倒塌
倒蹋=倒塌|倒塌
时勿=时务|時務
孝像=肖像|肖像
嚣叫=啸叫|嘯叫
嚣鸣=啸鸣|嘯鳴
嚣咤=啸咤|嘯吒
嚣叹=啸叹|嘯嘆
呼嚣=呼啸|呼嘯
印像=印象|印象
印相=印象|印象
佛象=佛像|佛像
木象=木像|木像
头象=头像|頭像
石象=石像|石像
玉象=玉像|玉像
镜象=镜像|鏡像
画象=画像|畫像
泥象=泥像|泥像
形象=形像|形像
肖象=肖像|肖像
摄象=摄像|攝像
显象=显像|顯像
好象=好像|好像
佛相=佛像|佛像
木相=木像|木像
头相=头像|頭像
石相=石像|石像
玉相=玉像|玉像
镜相=镜像|鏡像
画相=画像|畫像
泥相=泥像|泥像
形相=形像|形像
肖相=肖像|肖像
摄相=摄像|攝像
显相=显像|顯像
好相=好像|好像
像机=相机|相機
象机=相机|相機
像信=相信|相信
象信=相信|相信
像许=相许|相許
象许=相许|相許
照像=照相|照相
照象=照相|照相
泻下=泄下|泄下
泻漏=泄漏|泄漏
泻流=泄流|泄流
泻口=泄口|泄口
泻密=泄密|泄密
泻气=泄气|泄氣
泻水=泄水|泄水
泻涕=泄涕|泄涕
腹泄=腹泻|腹瀉
须要=需要|需要
急须=急需|急需
徇环=循环|循環
徇转=循转|循轉
参于=参与|參與
狭意=狭义|狹義
广意=广义|廣義
疑意=疑义|疑義
响映=响应|響應
公应=公映|公映
开应=开映|開映
制保=治保|治保
制疗=治疗|治療
制理=治理|治理
克治=克制|克制
控治=控制|控制
抉斗=决斗|決鬥
诀斗=决斗|決鬥
断抉=断决|斷決
判抉=判决|判決
对抉=对决|對決
断诀=断决|斷決
判诀=判决|判決
对诀=对决|對決
抉窍=诀窍|訣竅
决窍=诀窍|訣竅
抉别=诀别|訣別
决别=诀别|訣別
抉音=诀音|訣音
决音=诀音|訣音
抉去=诀去|訣去
决去=诀去|訣去
抉行=诀行|訣行
决行=诀行|訣行
粘亲=沾亲|沾親
粘染=沾染|沾染
粘惹=沾惹|沾惹
粘污=沾污|沾污
沾贴=粘贴|粘貼
黏贴=粘贴|粘貼
沾连=粘连|粘連
黏连=粘连|粘連
节道=截道|截道
节获=截获|截獲
节取=截取|截取
节止=截止|截止
截操=节操|節操
截气=节气|節氣
章截=章节|章節
时截=时节|時節
季截=季节|季節
联续=连续|連續
联属=连属|連屬
连防=联防|聯防
连欢=联欢|聯歡
连系=联系|聯繫
溶资=融资|融資
交溶=交融|交融
坚辛=艰辛|艱辛
坚难=艰难|艱難
奉交=奉缴|奉繳
缴叉=交叉|交叉
缴错=交错|交錯
缴代=交代|交代
缴往=交往|交往
缴接=交接|交接
缴友=交友|交友
缴驰=交驰|交馳
移缴=移交|移交
知缴=知交|知交
旧缴=旧交|舊交
深缴=深交|深交
记律=纪律|紀律
记检=纪检|紀檢
记元=纪元|紀元
计载=记载|記載
计录=记录|記錄
计号=记号|記號
计事=记事|記事
纪忆=记忆|記憶
计忆=记忆|記憶
纪性=记性|記性
计性=记性|記性
纪得=记得|記得
纪者=记者|記者
日纪=日记|日記
记划=计划|計劃
纪划=计划|計劃
记量=计较|計較
记较=计较|計較
混厚=浑厚|渾厚
混沦=浑沦|渾淪
浑杂=混杂|混雜
浑淆=混淆|混淆
浑乱=混乱|混亂
浑合=混合|混合
浑战=混战|混戰
浑帐=混帐|混帳
折除=拆除|拆除
折穿=拆穿|拆穿
折毁=拆毁|拆毀
折伙=拆伙|拆伙
折建=拆建|拆建
折迁=拆迁|拆遷
折散=拆散|拆散
折台=拆台|拆臺
折洗=拆洗|拆洗
折卸=拆卸|拆卸
强折=强拆|強拆
拆叠=折叠|折疊
拆断=折断|折斷
拆返=折返|折返
拆服=折服|折服
拆价=折价|折價
拆旧=折旧|折舊
拆扣=折扣|折扣
拆磨=折磨|折磨
拆射=折射|折射
拆寿=折寿|折壽
拆算=折算|折算
拆弯=折弯|折彎
拆腰=折腰|折腰
拆纸=折纸|折紙
拆枝=折枝|折枝
拆罪=折罪|折罪
曲拆=曲折|曲折
周拆=周折|周折
无宝=元宝|元寶
无旦=元旦|元旦
无丰=元丰|元豐
无嘉=元嘉|元嘉
无件=元件|元件
无老=元老|元老
无配=元配|元配
无气=元气|元氣
无曲=元曲|元曲
无首=元首|元首
无帅=元帅|元帥
无素=元素|元素
无宵=元宵|元宵
无凶=元凶|元凶
无勋=元勋|元勛
无夜=元夜|元夜
无音=元音|元音
无月=元月|元月
元比=无比|無比
元边=无边|無邊
元补=无补|無補
元猜=无猜|無猜
元常=无常|無常
元偿=无偿|無償
元成=无成|無成
元耻=无耻|無恥
元从=无从|無從
元道=无道|無道
元敌=无敌|無敵
元度=无度|無度
元妨=无妨|無妨
元非=无非|無非
元辜=无辜|無辜
元故=无故|無故
元关=无关|無關
元害=无害|無害
恩怒=怨怒|怨怒
埋怒=怨怒|怨怒
抱怒=怨怒|怨怒
怒恨=怨恨|怨恨
怒敌=怨敌|怨敵
怒府=怨府|怨府
怒毒=怨毒|怨毒
怒愤=怨愤|怨憤
怒女=怨女|怨女
怒悔=怨悔|怨悔
怒偶=怨偶|怨偶
怒声=怨声|怨聲
怒尤=怨尤|怨尤
怨潮=怒潮|怒潮
怨斥=怒斥|怒斥
怨放=怒放|怒放
怨吼=怒吼|怒吼
怨火=怒火|怒火
怨骂=怒骂|怒罵
怨目=怒目|怒目
怨容=怒容|怒容
怨色=怒色|怒色
怨视=怒视|怒視
怨涛=怒涛|怒濤
奕楸=弈楸|弈楸
奕谱=弈谱|弈譜
奕棋=弈棋|弈棋
膺品=赝品|贗品
膺碱=赝碱|贗碱
膺作=赝作|贗作
膺本=赝本|贗本
膺币=赝币|贗幣
赝选=膺选|膺選
赝赏=膺赏|膺賞
赝门=膺门|膺門
赝中=膺中|膺中
赝服=膺服|膺服
赝堂=膺堂|膺堂
赝运=膺运|膺運
赝命=膺命|膺命
赝任=膺任|膺任
己来=已来|已來
己去=已去|已去
己会=已会|已會
己走=已走|已走
己回=已回|已回
己定=已定|已定
己订=已订|已訂
己讲=已讲|已講
己降=已降|已降
己说=已说|已說
己想=已想|已想
己问=已问|已問
己复=已复|已覆
己覆=已覆|已覆
己而=已而|已而
己后=已后|已後
己矣=已矣|已矣
己然=已然|已然
己经=已经|已經
已方=己方|己方
自已=自己|自己
知已=知己|知己
晌板=响板|響板
晌应=响应|響應
晌声=响声|響聲
半响=半晌|半晌
幸苦=辛苦|辛苦
幸酸=辛酸|辛酸
幸亥=辛亥|辛亥
幸勤=辛勤|辛勤
幸辣=辛辣|辛辣
辛福=幸福|幸福
宠辛=宠幸|寵幸
士层=土层|土層
士地=土地|土地
士产=土产|土產
士豆=土豆|土豆
故士=故土|故土
烈土=烈士|烈士
护土=护士|護士
乌瞰=鸟瞰|鳥瞰
乌枪=鸟枪|鳥槍
体戚=休戚|休戚
体息=休息|休息
休材=体材|體材
休操=体操|體操
休察=体察|體察
休罚=体罚|體罰
休积=体积|體積
休检=体检|體檢
休态=体态|體態
休温=体温|體溫
休系=体系|體系
休现=体现|體現
休验=体验|體驗
身休=身体|身體
物休=物体|物體
群休=群体|群體
主休=主体|主體
固休=固体|固體
液休=液体|液體
文休=文体|文體
徙步=徒步|徒步
徙弟=徒弟|徒弟
徙劳=徒劳|徒勞
徙然=徒然|徒然
徙手=徒手|徒手
徙孙=徒孙|徒孫
徙刑=徒刑|徒刑
徙长=徒长|徒長
学徙=学徒|學徒
师徙=师徒|師徒
信徙=信徒|信徒
教徙=教徒|教徒
匪徙=匪徒|匪徒
暴徙=暴徒|暴徒
赌徙=赌徒|賭徒
叛徙=叛徒|叛徒
徒倚=徙倚|徙倚
徒边=徙边|徙邊
朝延=朝廷|朝廷
廷迟=延迟|延遲
廷缓=延缓|延緩
廷误=延误|延誤
廷续=延续|延續
廷滞=延滞|延滯
赡拜=瞻拜|瞻拜
赡仰=瞻仰|瞻仰
祟拜=崇拜|崇拜
祟奉=崇奉|崇奉
祟敬=崇敬|崇敬
祟尚=崇尚|崇尚
祟仰=崇仰|崇仰
推祟=推崇|推崇
尊祟=尊崇|尊崇
署假=暑假|暑假
署期=暑期|暑期
署气=暑气|暑氣
署热=暑热|暑熱
暑名=署名|署名
专暑=专署|專署
宫暑=宫署|宮署
官暑=官署|官署
签暑=签署|簽署
帅徒=师徒|師徒
帅资=师资|師資
技帅=技师|技師
戎边=戍边|戍邊
戊边=戍边|戍邊
修茸=修葺|修葺
鹿葺=鹿茸|鹿茸
蹒珊=蹒跚|蹣跚
蹒姗=蹒跚|蹣跚
券柜=卷柜|卷櫃
券轴=卷轴|卷軸
券子=卷子|卷子
券宗=卷宗|卷宗
券帘=卷帘|卷簾
券入=卷入|卷入
券袖=卷袖|卷袖
券笔=卷笔|卷筆
券饼=卷饼|卷餅
券尺=卷尺|卷尺
券发=卷发|卷髮
券曲=卷曲|卷曲
券刃=卷刃|卷刃
券逃=卷逃|卷逃
券烟=卷烟|卷煙
券扬=卷扬|卷揚
券云=卷云|卷雲
画券=画卷|畫卷
手券=手卷|手卷
试券=试卷|試卷
案券=案卷|案卷
书券=书卷|書卷
上券=上卷|上卷
下券=下卷|下卷
债卷=债券|債券
证卷=证券|證券
胜卷=胜券|勝券
睛天=晴天|晴天
睛朗=晴朗|晴朗
睛和=晴和|晴和
睛丽=晴丽|晴麗
睛爽=晴爽|晴爽
睛碧=晴碧|晴碧
眼晴=眼睛|眼睛
点晴=点睛|點睛
定晴=定睛|定睛
分沁=分泌|分泌
沁尿=泌尿|泌尿
沁乳=泌乳|泌乳
泌润=沁润|沁潤
泌凉=沁凉|沁涼
泌入=沁入|沁入
幂布=幕布|幕布
幂后=幕后|幕後
幂府=幕府|幕府
幂宾=幕宾|幕賓
幂僚=幕僚|幕僚
帐幂=帐幕|帳幕
夜幂=夜幕|夜幕
开幂=开幕|開幕
银幂=银幕|銀幕
帷幂=帷幕|帷幕
序幂=序幕|序幕
次幕=次幂|次冪
末必=未必|未必
末来=未来|未來
末尝=未尝|未嘗
末竟=未竟|未竟
末及=未及|未及
末曾=未曾|未曾
末定=未定|未定
末婚=未婚|未婚
末可=未可|未可
末免=未免|未免
末然=未然|未然
末有=未有|未有
末知=未知|未知
未梢=末梢|末梢
未端=末端|末端
未尾=末尾|末尾
未代=末代|末代
未业=末业|末業
未技=末技|末技
未子=末子|末子
未班=末班|末班
未路=末路|末路
未年=末年|末年
未篇=末篇|末篇
未期=末期|末期
未日=末日|末日
未世=末世|末世
未速=末速|末速
未药=末药|末藥
未叶=末叶|末葉
未艺=末艺|末藝
未造=末造|末造
泠天=冷天|冷天
泠藏=冷藏|冷藏
泠冻=冷冻|冷凍
泠僻=冷僻|冷僻
泠遇=冷遇|冷遇
泠漠=冷漠|冷漠
泠场=冷场|冷場
泠淡=冷淡|冷淡
泠调=冷调|冷調
泠风=冷风|冷風
泠汗=冷汗|冷汗
泠静=冷静|冷靜
泠酷=冷酷|冷酷
泠暖=冷暖|冷暖
泠却=冷却|冷卻
泠门=冷门|冷門
泠清=冷清|冷清
天泠=天冷|天冷
好泠=好冷|好冷
令天=今天|今天
令生=今生|今生
令世=今世|今世
令番=今番|今番
令年=今年|今年
令后=今后|今後
令昔=今昔|今昔
令朝=今朝|今朝
灸烤=炙烤|炙烤
灸热=炙热|炙熱
战粟=战栗|戰慄
廖落=寥落|寥落
廖廓=寥廓|寥廓
廖寂=寥寂|寥寂
寂廖=寂寥|寂寥
享通=亨通|亨通
亨乐=享乐|享樂
亨誉=享誉|享譽
亨年=享年|享年
亨受=享受|享受
亨用=享用|享用
亨有=享有|享有
亨堂=享堂|享堂
分亨=分享|分享
酒扫=洒扫|灑掃
酒泪=洒泪|灑淚
酒落=洒落|灑落
酒脱=洒脱|灑脫
酒了=洒了|灑了
挥酒=洒酒|灑酒
潇酒=洒酒|灑酒
洒席=酒席|酒席
洒筵=酒筵|酒筵
洒场=酒场|酒場
洒吧=酒吧|酒吧
洒保=酒保|酒保
洒菜=酒菜|酒菜
洒店=酒店|酒店
洒饭=酒饭|酒飯
洒馆=酒馆|酒館
洒鬼=酒鬼|酒鬼
洒柜=酒柜|酒櫃
洒会=酒会|酒會
洒家=酒家|酒家
洒浆=酒浆|酒漿
洒窖=酒窖|酒窖
洒精=酒精|酒精
洒具=酒具|酒具
洒量=酒量|酒量
洒龄=酒龄|酒齡
洒钱=酒钱|酒錢
洒肉=酒肉|酒肉
洒窝=酒窝|酒窩
洒醒=酒醒|酒醒
洒兴=酒兴|酒興
洒宴=酒宴|酒宴
洒药=酒药|酒藥
白洒=白酒|白酒
啤洒=啤酒|啤酒
料洒=料酒|料酒
鸡洒=鸡酒|雞酒
尾洒=尾酒|尾酒
茅洒=茅酒|茅酒
台洒=台酒|台酒
饮洒=饮酒|飲酒
喝洒=喝酒|喝酒
幼想=幻想|幻想
幼象=幻象|幻象
幼像=幻像|幻像
幼影=幻影|幻影
幼觉=幻觉|幻覺
幼境=幻境|幻境
幼灭=幻灭|幻滅
魔幼=魔幻|魔幻
虚幼=虚幻|虛幻
梦幼=梦幻|夢幻
奇幼=奇幻|奇幻
幻儿=幼儿|幼兒
幻虫=幼虫|幼蟲
幻苗=幼苗|幼苗
幻师=幼师|幼師
幻教=幼教|幼教
幻驹=幼驹|幼駒
幻林=幼林|幼林
幻嫩=幼嫩|幼嫩
幻年=幼年|幼年
幻时=幼时|幼時
幻体=幼体|幼體
幻童=幼童|幼童
幻小=幼小|幼小
幻稚=幼稚|幼稚
幻子=幼子|幼子
侯车=候车|候車
侯场=候场|候場
侯审=候审|候審
侯诊=候诊|候診
侯补=候补|候補
侯鸟=候鸟|候鳥
等侯=等候|等候
伺侯=伺候|伺候
问侯=问候|問候
时侯=时候|時候
气侯=气候|氣候
候爵=侯爵|侯爵
候门=侯门|侯門
封候=封侯|封侯
诸候=诸侯|諸侯
衷悼=哀悼|哀悼
衰悼=哀悼|哀悼
衷叹=哀叹|哀嘆
衰叹=哀叹|哀嘆
衷鸣=哀鸣|哀鳴
衰鸣=哀鸣|哀鳴
衷请=哀请|哀請
衰请=哀请|哀請
衷怜=哀怜|哀憐
衰怜=哀怜|哀憐
衷劝=哀劝|哀勸
衰劝=哀劝|哀勸
衷告=哀告|哀告
衰告=哀告|哀告
衷求=哀求|哀求
衰求=哀求|哀求
衷怨=哀怨|哀怨
衰怨=哀怨|哀怨
默衰=默哀|默哀
默衷=默哀|默哀
哀肠=衷肠|衷腸
衰肠=衷肠|衷腸
哀曲=衷曲|衷曲
衰曲=衷曲|衷曲
哀心=衷心|衷心
衰心=衷心|衷心
由哀=由衷|由衷
苦哀=苦衷|苦衷
折哀=折衷|折衷
由衰=由衷|由衷
苦衰=苦衷|苦衷
折衰=折衷|折衷
哀微=衰微|衰微
衷微=衰微|衰微
哀弱=衰弱|衰弱
衷弱=衰弱|衰弱
哀老=衰老|衰老
衷老=衰老|衰老
哀竭=衰竭|衰竭
衷竭=衰竭|衰竭
哀落=衰落|衰落
衷落=衰落|衰落
哀败=衰败|衰敗
衷败=衰败|衰敗
哀减=衰减|衰減
衷减=衰减|衰減
哀退=衰退|衰退
衷退=衰退|衰退
哀亡=衰亡|衰亡
衷亡=衰亡|衰亡
拨腿=拔腿|拔腿
拨草=拔草|拔草
拨牙=拔牙|拔牙
拨毒=拔毒|拔毒
拨毛=拔毛|拔毛
拨河=拔河|拔河
拨城=拔城|拔城
拨尖=拔尖|拔尖
拨剑=拔剑|拔劍
拔动=拨动|撥動
拔发=拨发|撥發
拔付=拨付|撥付
拔开=拨开|撥開
拔给=拨给|撥給
拔打=拨打|撥打
拔号=拨号|撥號
拔款=拨款|撥款
蒙敝=蒙蔽|蒙蔽
敝开=敞开|敞開
敝平=敞平|敞平
敝亮=敞亮|敞亮
宽敝=宽敞|寬敞
荼杯=茶杯|茶杯
荼具=茶具|茶具
荼叶=茶叶|茶葉
荼水=茶水|茶水
荼饭=茶饭|茶飯
荼点=茶点|茶點
剌探=刺探|刺探
剌杀=刺杀|刺殺
剌透=刺透|刺透
剌客=刺客|刺客
剌刀=刺刀|刺刀
剌猬=刺猬|刺蝟
剌绣=刺绣|刺繡
剌人=刺人|刺人
剌激=刺激|刺激
剌骨=刺骨|刺骨
剌耳=刺耳|刺耳
讥剌=讥刺|譏刺
讽剌=讽刺|諷刺
被剌=被刺|被刺
行剌=行刺|行刺
泼刺=泼剌|潑剌
勿忙=匆忙|匆忙
勿促=匆促|匆促
勿猝=匆猝|匆猝
勿勿=匆匆|匆匆
请匆=请勿|請勿
代木=伐木|伐木
讨代=讨伐|討伐
征代=征伐|征伐
叼念=叨念|叨念
叼咕=叨咕|叨咕
唠叼=唠叨|嘮叨
渝期=逾期|逾期
钟罄=钟磬|鐘磬
溃乏=匮乏|匱乏
宵汉=霄汉|霄漢
绎著=译著|譯著
绎制=译制|譯製
绎音=译音|譯音
绎本=译本|譯本
绎笔=译笔|譯筆
绎电=译电|譯電
绎稿=译稿|譯稿
绎码=译码|譯碼
绎名=译名|譯名
绎文=译文|譯文
绎注=译注|譯註
脏款=赃款|贓款
飘缈=缥缈|縹緲
漂缈=缥缈|縹緲
日幕=日暮|日暮
日慕=日暮|日暮
日募=日暮|日暮
险骏=险峻|險峻
高骏=高峻|高峻
险竣=险峻|險峻
高竣=高峻|高峻
险俊=险峻|險峻
高俊=高峻|高峻
完峻=完竣|完竣
告峻=告竣|告竣
完骏=完竣|完竣
告骏=告竣|告竣
完俊=完竣|完竣
告俊=告竣|告竣
间碟=间谍|間諜
碟查=谍查|諜查
翻茄=番茄|番茄
翻薯=番薯|番薯
翻瓜=番瓜|番瓜
杆粮=干粮|乾糧
搅绊=搅拌|攪拌
色采=色彩|色彩
簙饼=薄饼|薄餅
簙板=薄板|薄板
扳权=版权|版權
板权=版权|版權
扳署=版署|版署
板署=版署|版署
辨护=辩护|辯護
辫护=辩护|辯護
瓣护=辩护|辯護
抵毁=诋毁|詆毀
诋达=抵达|抵達
凸然=突然|突然
凸发=突发|突發
凸变=突变|突變
拖起=托起|托起
拖运=托运|托運
坍踏=坍塌|坍塌
坍蹋=坍塌|坍塌
踏陷=塌陷|塌陷
蹋陷=塌陷|塌陷
泄肚=泻肚|瀉肚
泄火=泻火|瀉火
泄药=泻药|瀉藥
泄盐=泻盐|瀉鹽
义境=意境|意境
义料=意料|意料
义图=意图|意圖
义思=意思|意思
义念=意念|意念
义下=意下|意下
义用=意用|意用
义识=意识|意識
意子=义子|義子
意父=义父|義父
意女=义女|義女
意母=义母|義母
意儿=义儿|義兒
治裁=制裁|制裁
治作=制作|製作
治办=制办|製辦
治授=制授|制授
口抉=口诀|口訣
秘抉=秘诀|秘訣
妙抉=妙诀|妙訣
口决=口诀|口訣
秘决=秘诀|秘訣
妙决=妙诀|妙訣
诀择=抉择|抉擇
诀摘=抉摘|抉摘
消熔=消融|消融
捡菜=拣菜|揀菜
捡人=拣人|揀人
捡换=拣换|揀換
捡发=拣发|揀發
交枪=缴枪|繳槍
交获=缴获|繳獲
交销=缴销|繳銷
交墙=缴墙|繳牆
记年=纪年|紀年
世记=世纪|世紀
音晌=音响|音響
响午=晌午|晌午
沓渺=杳渺|杳渺
杳杂=沓杂|沓雜
疲杳=疲沓|疲沓
辛存=幸存|倖存
辛亏=幸亏|幸虧
土卒=士卒|士卒
候乌=候鸟|候鳥
迁徒=迁徙|遷徙
延杖=廷杖|廷杖
瞻养=赡养|贍養
作崇=作祟|作祟
酷署=酷暑|酷暑
命今=命令|命令
县今=县令|縣令
法今=法令|法令
针炙=针灸|針灸
盛哀=盛衰|盛衰
兴哀=兴衰|興衰
盛衷=盛衰|盛衰
兴衷=兴衰|興衰
挺拨=挺拔|挺拔
海拨=海拔|海拔
代木=伐木|伐木
代树=伐树|伐樹
